네	yes
있다	 to exist to have to stay
학교	 school
집	house, home
하다	to do
먹다	to eat
아니요	no
책	book
보다	to see, to look at
학생	student
사람	person, people
가다	to go
선생님	teacher
저	Ithat (over there)
안녕하다	to be well, be in good health
이름	name
한국	Korea
공부하다	to study
친구	friend
물	water
없다	to not existto not have
시간	time hours
어디	where
말하다	to speak
그	that (before nouns)
여자	woman, female
예쁘다	to be pretty, charming
돈	money
커피	coffee
만나다	to meet
책상	desk
한국어	Korean (language)
오다	to come
뭐	what
남자	man, male
좋다	to be good, be niceto like
오늘	today
차	teacar
마시다	to drink
아버지	father
누구	who
크다  to be big	
이	tooththis
카메라	camera
주다	to give
사랑	love
영어	English (language)
읽다	to read
밥	rice (cooked) meal
이거	this thing
감사하다	to be thankful, thank, appreciate
어머니	mother
주스	juice

듣다	to listen, to hear
가방	bag
같이	together
쓰다	to writeto use
일	work, matterday
미국	USA
나쁘다	to be bad
전화	telephone
볼펜	ballpoint pen

사다	to buy
영화	movie
노래	song
사랑하다	to love
진짜	really, veryreal thing
우유	milk
어렵다	to be difficult, hard
왜	why
머리	headhair
알다	to know
빨리	quickly
사과	appleapology
자다	to sleep
제	my

월요일	Monday
재미있다	to be fun, interesting

여기	here
동생	younger sibling
춥다	to be cold (regarding the weather)
일본	Japan
옷	clothes
노래하다	to sing
그럼	then, if sothat's right
연필	pencil
모르다	to not know
어제	yesterday
생각	thought, idea

살다	to live

대학교	college
방	a room
앉다	to sit, sit down
화요일	Tuesday
의자	chair
운동하다	to work out, to exercise
날	day, dateedge
아침	morning, breakfast
물어보다	to ask, question
서울	Seoul

요리	cooking, dish
놀다	to hang out, to play
맥주	beer
잘	well
길다	to be long
이쪽	this side, our side

수요일	Wednesday
비싸다	to be expensive
문	door
많이	a lot, many, plenty
맛있다	to be delicious, tasty
음악	music
지금	now
작다	to be small
말	words, languagehorse
사전	dictionary
죄송하다	to be sorry, feel guilty
좀	a littlekindlycertainly

가게	shop, store
입다	to wear
김밥	Korean dried seaweed rice rolls

언제	when
요리하다	to cook
질문	question
눈	eyesnow
아프다	to be sickto hurt, ache
청소	cleaning
내일	tomorrow
쉽다	to be easy
술	alcoholic drink
저기	over there
이야기하다	to talk
숙제	homework
어떻게	how
시작하다	to start, begin
년	year
그리고	and

아니다	to not be

목요일	Thursday
피자	pizza
찾다	to look forto findto withdraw (money)
끝	end

자동차	car
청소하다	to clean up, to vacuum
오빠	older brother (of a female)
다음	the next, the following
바쁘다	to be busy
회사	company, corporation
번	time (first, second...)
만들다	to make
바지	pants
저녁	eveningdinner

타다	to ride, get into burn, be tanned
버스	bus
개	dogthing (<i>count.</i>)

다니다	to go (frequently),to attend, work for
구두	dress shoes
치즈	cheese

일어나다	to wake up, get upto happen
중국	China
비	rainbroom
맞다	to be correctto be hit, struck
금요일	Friday
자주	often
쉬다	to rest, take a rest
형	a man's older brother<br />type, style<br />punishment
컴퓨터	computer
날씨	weather
끝나다	to end, be over
감자	potato

더	more
싸다	to be inexpensive, cheapto wrap up, pack
은행	bank
혼자	alone
기다리다	to wait
배	pearstomachboat
아이	child
그렇다	to be so (like that)
나라	country, nation

셔츠	shirt

일하다	to work
가족	family
안녕히	peacefullysafely
배우다	to learn
공책	notebook
쪽	side, directionpage

싫다	to be unlikable, to not like
독일	Germany
텔레비전	TV
다르다	to be different

이번	this time
공원	park
돕다	to help
얼마	how much (money)
여행	trip, travel
늦다	to be late
다	all
바나나	banana

피곤하다	to be tired
요일	day of the week
거기	there

도착하다	to arrive
도서관	library
너무	too (much)
받다	to receive, acceptto take
딸	daughter
그래서	therefore
보이다	to be visibleto show, display
토요일	Saturday
생일	birthday
좋아하다	to like
부모님	parents
밤	night
생각하다	to think
문제	problem, question
이쪽으로	this way, over here

사진	picture, photo
재미없다	to be boring, dull

아이스크림	ice cream
점심	lunch afternoon
앞	the front
전화하다	to make a phone call
프랑스	France

일요일	Sunday
치마	skirt
부르다	to call, to call out
고양이	cat
시험	exam, test
여러분	everyone, ladies and gentlemen

멀다	to be far

아들	son
시	poemtime, houro'clock
수업	class, instruction
나오다	to come out
우리	we (<i>informal</i>)
빵	bread
화장실	toilet, bathroom
수영하다	to swim
무슨	which/what (+ noun)
오렌지	orange
죽다	to die

병원	hospital
정말	really, seriously
선물	present, gift
되다	to become, get, turn into
새	newbird

약속	appointmentpromise
웃다	to laugh, smile
매일	every day
클래스	class

하지만	but, though

못하다	to be unable to do
안	inside, within<br />notproposal
토마토	tomato

닫다	to close
요즘	these days
지하철	subway
지내다	to spend timeto pursueto associate with

캐나다	Canada

잔	cup, glass
점원	salesperson
많다	to be many, to be plenty
주일	week
마음	mind, heart, nature

월	month
중요하다	to be important
저쪽	that side, over there

고기	meat

꽃	flower
반갑다	to be glad, happy, pleased

그런데	by the way, but then
거리	distancestreet, road
버리다	to abandon, to throw away
분	minuteperson (hon.)
시장	marketmayor
오월	May
가깝다	to be close
얼마나	how + adjective/adverb
식당	restaurant, cafeteria, diner
호주	Australia
덥다	to be hot (regarding the weather)
몇	how many

취미	hobby
옷장	wardrobe, closet
내리다	to come down, put downto get out ofto take off
시계	clock, watch
보통	usually, normally
햄버거	hamburger

열다	to open
옆	beside, next to
의사	doctor, physicianintention, idea
말다	to not do
다시	again
신문	newspaper
여동생	younger sister
적다	to write down, fill outto be small in quantity
열심히	diligently, passionately
손	hand
가르치다	to teach
유월	June
아직	yet, still
이상하다	to be strange (unusual)
나중에	later
등	the backgrade, class
회사원	company employee (in an office)
놓다	to lay, put, placeto let go
조금	a little
음식	food
운전하다	to drive
곳	place

남동생	younger brother
짧다	to be short

냉장고	refrigerator
천천히	slowly

태어나다	to be born

한식	Korean-style food
원	won (Korean currency)circle
기쁘다	to be glad, happy, pleased

누나	older sister (of a male)
올해	this year

결혼하다	to get married
나이	age
그림	picture
남다	to remain, to be left
달걀	egg

늦게	late
괜찮다	to be okay
침대	bed
병	bottlesickness, disease
팔다	to sell
직업	job, occupation
여름	summer

같다	to be the same (as)to look like, seem like
나	I (<i>informal</i>)
극장	movie theatertheater
잡다	to catch, grab, take
지난	last, previous

엄마	mom

나가다	to go out
자전거	bicycle
주문하다	to order (smth.)
고향	hometown
어떤	some, certainwhat kind of
춤추다	to dance

때	time whenoccasiondirt

언니	older sister (of a female)
준비	preparation, arrangement
울다	to cry
일월	January
가수	singer
그래도	nevertheless, still, however

찍다	to take a picture<br />to mark
초콜릿	chocolate

일찍	early (adv.)
잠	sleep, nap

힘들다	to be difficult, tiring, painful

아빠	dad

김치	kimchi (traditional Korean dish made of seasoned vegetables and other ingredients)

작년	last year
내다	to payto produce
영국	United Kingdom
주말	weekend
그렇지만	but, however

따뜻하다	to be warm, kind

이월	February
핸드폰	cellphone
씻다	to wash
편지	letter, note
봄	spring

슬프다	to be sad
오전	before noon
인터넷	internet

맵다	to be spicy, hotto be intense
백화점	department store
명	counter for people
검다	to be black

얘기	storytalk, conversation

제일	the most
빌리다	to borrow
포도	grape
삼월	March
걷다	to walk
공항	airport
달	month, moon

농구	basketball
세수하다	to wash one's face
가끔	sometimes
씨	Mr., Ms.seed, kernel
보내다	to send<br />to pass (spend) time
오후	after noon
서점	bookstore
배고프다	to be hungry
무엇	what, which, something (the unshortened form of 뭐)

맛	taste
비빔밥	boiled rice with assorted mixtures

걸리다	to take timeto be caught
창문	window
일본어	Japanese (language)
싫어하다	to dislike
또	again, repeatedlyalso, too

기억	memory
검은색	black

치다	to play a gameto hit, attack
나무	tree wood
대답	answer
설악산	Seoraksan (mountain)
깨끗하다	to be clean

모두	all together, everyone

너	you (<i>informal</i>)
그래	yes, okay

수고하다	to work hard, keep up the effort

먼저	first, ahead
층	floor (count.)
사월	April
조용하다	to be quiet
사무실	office
벌써	already
들어가다	to enter, go in
잠시	a short while
위	above
한번	one time
귀엽다	to be cute
부엌	kitchen

이런	such

소개하다	to introduce, recommend
목	neckthroat
여러	many, several
흰색	white

가지다	to posess (have)

할머니	grandmother
만약	if
화	angerdisaster, misfortune
잘하다	to do well, be skillful
오이	cucumber

처음	for the first timethe origin

비슷하다	to be similar
칠월	July
길	street, road
어느	which

축하하다	to congratulate
택시	taxi
마지막	the last, final one
한국말	Korean language
서다	to standto stop

속	inside

빨간색	red

빨래하다	to do laundry
팔월	August
수박	watermelon
차갑다	to be cold (regarding objects)
대	counter for vehicles and other machinery
종이	paper
며칠	several daysday of the month

걱정하다	to worry
테이블	table

오래	a long time

배우	actor
놀라다	to be surprised, astonished, startled
힘	power, strength, force, capability

잡지	magazine, journal
계시다	to exist (hon.)
남편	husband
별로	not particularly
파티	party (social gathering)
화나다	to be angry, mad
구월	September
산	mountain
빨갛다	to be red

아래	under

교실	classroom
잘못하다	to make a mistake
왼쪽	left side
코트	coat
따르다	to follow, go afterto pour, fill

겨울	winter

모자	hat, capmother and son
시월	October
필요하다	to need
키	height

청바지	blue jeans
고맙다	to be thankful, grateful
물건	thing, object, article
이렇게	like this, in this way
소금	salt

끝내다	to finish (something)
수학	mathematics
뒤	behind
편의점	convenience store
유명하다	to be famous
우산	umbrella
저희	we, our

들어오다	to come in, enter
아저씨	mister
안경	glasses, eyeglasses
행복하다	to be happy
값	price, cost

동안	during, interval

뜨겁다	to be hot (regarding objects)
식사	meal
오른쪽	right side

거실	living room
설명하다	to explain
불	firelight
그러니까	therefore, consequently

아줌마	middle aged woman

아름답다	to be beautiful

십일월	November
외국	foreign country
아내	wife
나다	to appear, come outto break
역	train stationpart in a play
도시	city
드리다	to give, offer (hon.)

얼굴	face

인사	greetings
거짓말	lie
무겁다	to be heavy
모든	all every

공	ball

날짜	date (in a calendar)
구경하다	to go sightseeing, look aroundto see, watch (a show, movie, play, sports game etc.)
소리	sound, noise

앞으로	from now on

들다	to be included, be amongto pick up, hold, carryto mention, state
팔	arm
십이월	December
기숙사	dormitory
어둡다	to be dark, gloomy

중국어	Chinese (language)
바로	right theredirectly

생선	fish (for eating)
연습하다	to practice, train
데	spot, place

하루	(one) day, 24 hours

외국어	foreign language
빠르다	to be quick, fast
반지	ring
쇼핑	shopping
노랗다	to be yellow

밖	the outside
만화	comic book
사실	fact, truth
출근하다	to go (get) to work
언제나	alwaysusually

건강	health
높다	to be highto be noble

그냥	justwithout any special reason

지난주	last week
컵	cup

계속하다	to continue
휴가	vacation (in general)
방금	a moment ago
학년	school year
벌다	to earn (money)

전	before, prior to
색깔	color
신발	shoes, footwear

잊다	to forget

설탕	sugar
함께	together, in company with

글	writing, a piece of writing, text
사용하다	to use, make use of
데이트	date, going out

사고	accident
그만하다	to stop (doing something)
라면	ramen

서로	each other, mutually

생기다	to occur, happento lookto form

약	drug, medicineapproximately
아마	probably, maybe
미안하다	to be sorry (less formal)
과일	fruit

항상	always
싸우다	to argue, fight

지갑	walletpurse
가장	the most (more formal than제일)
이해하다	to understand, grasp
반	halfgroup, class
농담	joke
아기	baby
바꾸다	to change, switch, alter
가을	autumn

쇠고기	beef (2)

낮다	to be low

담배	cigarette
방학	vacation (from school)
가져오다	to bring

권	counter for books
열쇠	key

그리다	to draw a picture
여자친구	girlfriend
아주	very much
양말	socks
틀리다	to be wrong, mistaken

아니	no, not
주소	address, residence
벽	wallcharacteristic
퇴근하다	to go home from work
자기	self, oneself
방법	way, method
감기	cold (the illness)
똑똑하다	to be smart, bright, intelligent

계속	continuously
지도	map, chart
가볍다	to be light (as opposed to heavy)

마리	counter for animals

문학	literature
밝다	to be bright, lightto be promisingto be sharp, keen

강	river
반말	plain speech
외우다	to memorize

할아버지	grandfather
비밀	secret
노란색	yellow

즐겁다	to be pleasant, joyful, cheerful, happy

인기	popularity
전혀	completely(not) at all
조심하다	to be careful, watch out
바다	sea, ocean

과학	science
더럽다	to be dirty

몸	body, figure

잠깐	for a little while
강하다	to be strong, powerful
축구	football (soccer)
역사	history
내	my <i>(informal)</i>
잘못되다	to go wrong

다리	legbridge
번호	number
운동장	field, (school) stadiumplayground
실례하다	to be excused
콜라	coke
사이	relationshipdistance apart
스포츠	sports

부탁하다	to request, ask a favor
스페인	Spain

기분	mood, feeling
갑자기	suddenly

다치다	to get hurt
궁금하다	to be curious, to wonder

자리	room, space, place (for something)mat
내년	next year
파랗다	to be blue

섬	island

그렇게	so, like that
건강하다	to be healthy
냄새	smell, scent

직장	workplace, job
지나다	to pass, go by

반바지	shorts
소파	sofa

독학	self-study
연락하다	to contact, keep in touch
오랜만에	after a long time

느낌	feeling, sensation

졸업하다	to graduate
교수	professorteaching, instruction
손님	guestcustomer
오르다	to rise, go up

입	mouth
비행기	airplane
닦다	to wipeto polish

위험	danger, risk
유행	fashion
믿다	to believe, trust
교과서	textbook
꼭	certainly, for sure

날씬하다	to be slim, slender

대화	conversation
날마다	every day

시원하다	to be cool, refreshing

신경	nerves
유학	studying abroad
인도	Indiasidewalk
시끄럽다	to be noisy

당근	carrot

계획	plan, project
피우다	to smoketo bloom, blossomto make a fire
코	nose
부산	Busan
우체국	post office
어리다	to be young, little

바람	wind, breezewish, desire

야구	baseball
복잡하다	to be crowdedto be complicated
목욕	bath
때문에	because of

꿈	dream (while sleeping)

넓다	to be wide, spacious
이제	now (after something)

경기	game (football etc.)
지키다	to defend, protect
사실은	in fact
약국	pharmacy
즐기다	to enjoy oneself

초록색	green
낮	daytime

그때	then, at that time

안다	to hug, hold

아가씨	miss, young lady
불고기	marinated beef

주무시다	to sleep (hon.)

해	yearsunharm
아무튼	anyway, in any case

드라마	drama

내려오다	to come down, get off

비누	soap

근처	nearby
낫다	to be betterto get better, to heal
가구	furniturehousehold
닭	chicken

변하다	to change
세탁	washing
젓가락	chopsticks

친절하다	to be kind, considerate
계단	stairs
글쎄	well, let me see

켜다	to turn on, switch on
어른	adultone's senior
기자	reporter
그쪽	that, that wayyou

달리다	to runto hangto depend on
재미있게	interestingly, in a fun way

못	nailcannot
하얗다	to be white
주인	owner, employer
아무나	anybody

기억나다	to remember, recollect

지난달	last month

군데	place, spot

사탕	candy
어떻다	to be the manner in which something is done

귀	ear
이따가	a little later

잃다	to lose (something)
교회	church
그릇	bowl, container

펴다	to open, unfold, spread

중에서	among, between
목소리	voice

소식	news (from people you know)
밝히다	to brighten (up), lightento clarify, disclose
침실	bedroom
북쪽	north
구름	cloud

벗다	to take off (clothes)
닭고기	chicken (meat)

밑	the bottom, below

만지다	to touch
모레	the day after tomorrow

시내	the city, downtown
달다	to be sweetto put up, attach

거의	almost
간호사	nurse
불안하다	to be anxious, uneasy
배달	delivery
아무도	no one, nobody

곧	soon

흐리다	to be cloudy

장갑	glove
말고	not ... but ...
복습하다	to review
새벽	dawn

정도	degree, extent
숟가락	spoon

출발하다	to depart, leave
달력	calendar
회의	meeting, conference
끄다	to put out, turn off

훨씬	by far, much
부탁	request
줄	line, rope
샤워하다	to take a shower

그러나	but, though, however

접시	plate, dish

드시다	to eat, drink (hon.)

경제	economy
개월	months (count.)
잘생기다	to look good, be handsome

문장	sentence
가위	scissors

초대하다	to invite
점	dot, pointviewpointfortune-telling
호텔	hotel

갈비	barbecued spare ribs

알아보다	to find out,check out, investigateto recognize
허리	waist

물론	of course
편하다	to be convenient, comfortable
까만색	black

자신	oneselfself-confidence
헤어지다	to break up, part, separate

사거리	intersection, crossroads
국	soup

가운데	center

다녀오다	to go and get back, be back

학원	educational institute, academy
장소	place, location
착하다	to be nice (good-natured)
호수	lakenumber (of a house or room)
보기	example

야채	vegetable
마르다	to be dry, become dryto become thin, lose weight

팥	red-beans

신호	signal
덮다	to cover, shut, close

굉장히	very, extremely, very much
하늘	the sky
돌아가다	to go back, returnto work, operate
아까	a while ago
기침	cough
불다	to blow

케이크	cake

살	years of age (<i>count.</i>)flesh, muscle
짜다	to organize, constructto be salty

카페	café
욕실	bathroom
이사하다	to move (to live elsewhere)
건물	building
달러	dollar

넣다	to put in, insert

종업원	waiter, waitress
가슴	chest

장	counter for sheets (of paper or similar material)intestine
짓다	to make, build, construct
그녀	she

단어	word, vocabulary
남자친구	boyfriend
고르다	to choose, pick
어린이	young child, kid
딸기	strawberry

혹시	by any chance perhaps
돌다	to turn, rotate, revolve
문화	culture
참	very, really

무섭다	to be scary, frightening, fearfulto be scared
소풍	picnic
이미	already, yetpreviously
묻다	to askto bury
이유	reason, cause
녹색	green
오래간만	first time in a while

떨어지다	to fall, crash
예문	example sentence
스파게티	spaghetti

뚱뚱하다	to be fat

발	foot
아르바이트	part-time job

이기다	to win

기차	train
어깨	shoulder

따라하다	to imitate, repeat (after)

직접	directly, personally
강아지	puppy

끊다	to cut off, break off
냉면	cold noodle soup
사장	president of a company
각	each, everyangle
맑다	to be clear, clean

제주도	Jeju Island
경찰	police, police officer
전화기	telephone (set)
신다	to put on, wear (footwear)

눈물	tear

노력	effort
어울리다	to match, fit, suit well, look goodto associate (with), get along (with)

어서	please, kindlyquickly

뉴스	news
갔다오다	to go and come back

노래방	karaoke room
간장	soy sauce
휴게실	lounge, resting room
건너다	to cross (over)

게임	game
표	tickettable, diagrammark, sign
쓰레기	garbage, trash

해보다	to try to experience

손가락	finger

남녀	men and women
자르다	to cut, slice
옛날	old times, the past

설거지	dishwashing

봉투	envelope, bag
나타나다	to appear, turn upto be revealed

초등학교	elementary school
복숭아	peach

불편하다	to be inconvenient, uncomfortable
칼	knifesword

추석	Korean harvest festival
내려가다	to go down

부부	a married couple
지하	underground, basement
걸다	to hang, suspendto speak to, call

수영장	swimming pool
반찬	side dish
시장보다	to go grocery shopping
공연	public performance
최고	the best, the highest, top
팀	team

돌아오다	to come back, return
곧장	straight, directly

자연	nature
한글	Korean alphabet
갖다	to have, to hold

공사	construction
모습	figure, shape, features

깎다	to peel, trim, cutto discount (cut the price)

특히	especially, particularly
남쪽	south
까맣다	to be black

예	exampleyes
가전제품	electric home appliance
산책하다	to take a walk
당신	you (formal)
조건	condition, term
세상	the world, society
날다	to fly

외국인	foreigner
교통	traffic
말씀하시다	to speak, talk (hon.)
실수	mistake, error
언어	language
왕	king
올라가다	to go up

피부	skin
발음	pronunciation
참다	to endure, bear
한복	Korean dress (traditional)
인터뷰	interview

첫째	first, the foremost

막히다	to be blocked, be stopped

소주	Korean hard liquor
맞은편	opposite side
시청	city hall
희다	to be white, fair

과자	cookie, snack
미터	meter

휴지	toilet paper, tissuepause
전하다	to convey, communicate, reportto teach, introduce
포도주	wine
과	departmentlesson, chapter
멋있다	to be attractive, stylish, cool
첫날	the first day

에어컨	air conditioner

과거	the past
꺼내다	to pull, take out

후식	dessert
서쪽	the west
떠나다	to leave, depart

피아노	piano
계절	season
친하다	to be close, friendly, intimate with
규칙	rule, regulation
요리사	cook, chef
당연하다	to be reasonable, natural
중학교	middle school (junior high)
생활	life, living, livelihood
성	family namecastlegender
외롭다	to be lonely

경찰서	police station
학기	semester
얻다	to get, to gain
아파트	apartment

소고기	beef

편리하다	to be convenient, handy
잎	leaf
최근	lately, most recently
시키다	to order, force someone

메시지	message

일부	part, section, portion
박물관	museum
느끼다	to feel, experience

정신	mind, spirit, soul
내용	contents, substance
현재	the present (tense)
걸어가다	to walk (somewhere)

카드	card
숨	breath, breathing

눕다	to lie down
분위기	atmosphere, mood
고등학교	high school
외식하다	to dine out
배추	Chinese cabbage

레슨	lesson

갖다주다	to bring over

중간	middle
메뉴	menu

세우다	to make something stand, erectto stop, parkto set (up)

부분	part, portion
별	star

심심하다	to be bored

정보	information
소설	novel
자장면	Chinese dish of noodles in black soybean paste

다행이다	to be lucky, fortunate
의미	meaning, sense
수건	towel
고치다	to fix, repair
거울	mirror

사회	society, community
이용하다	to use, take advantage of
가지	kind (of), sort (of)branch, twigeggplant

홍차	black tea
관계	relationship, connection
튼튼하다	to be strong, solid, healthy

휴일	public holiday
적	enemy, opponent, rival
되게	very, really, extremely

밉다	to be hateful, dislikeableto be ugly
동물	animal
버섯	mushroom

비디오	video
복사하다	to reproduce, copy
돼지	pig

가까이	near (to), closenearly

지우다	to erase, cross outto wash off

초	seconds
미래	future
사귀다	to date, go outto make friends with, keep company with

퍼센트	percent

술집	bar, pub

잃어버리다	to lose something (completely)
그저께	day before yesterday

문법	grammar
남기다	to leave behind, save

주차장	parking lot
매우	very, so, much

급하다	to be in a hurry, be urgent
매력	charm, attractiveness
입술	lips

사라지다	to disappear

사업	enterprise, business
아무데나	any place, anywhere

새롭다	to be new, fresh

편	side
넥타이	necktie

지나가다	to go through, pass
벌레	bug, insect

뉴욕	New York

졸리다	to feel sleepy
장미	rose
태권도	Taekwondo
잡수시다	to eat (hon.)

슈퍼마켓	supermarket

계란	egg
대단하다	to be great, tremendousto be wonderful

약간	a little, slightly
칠판	blackboard
결정하다	to decide
성함	name (hon.)
운동화	sports shoes
부럽다	to be jealous, envious

목걸이	necklace

언젠가	someday
똑같다	to be exactly the same

연구	research
채소	vegetable
입원하다	to be hospitalized
가격	price
평소에	usually, ordinarily
풀다	to solve untie
동사	verb
성격	character, personality
던지다	to throw
조용히	silently, quietly

대학	university
도망가다	to run away, escape
목적	purpose, aim, goal
한가지	the sameone thing, a kind, a sort

유리	glass
부드럽다	to be soft, smooth

더위	the heat

경우	case, circumstances, scenario
애인	lover, sweetheart
굽다	to bake, roast, toastto be crooked, be bent
웬일	what matter, what cause

팔찌	bracelet

집중하다	to concentrate (upon)
꽤	substantially, fairly
장마	rainy season, rainy spell

대하다	to face, confrontto treat
결국	after all, finally, in the end
아주머니	middle aged womanaunt
이마	forehead

따라가다	to follow, go after, tag along

인생	life (human)
귤	tangerine, mandarin
여전히	still, as ever
일으키다	to raise, set somebody upright

숫자	numbers
어쩌면	maybe

사건	incident, affair, event
가난하다	to be poor

센티미터	centimeter

설마	impossibly, can't be true

간식	snack
두다	to put, place, layto leave (behind, as is)

화장품	cosmetics
큰길	main road

좁다	to be narrow
죽	porridge, gruelin a row
부인	[your] wife (hon.)woman, ladydenial, disapproval
도와주다	to help out, assist
예전	the old days before

존댓말	polite/formal language (speech)
한잔하다	to have a drink
진심으로	sincerely, from one's heart
정치	politics
지다	to lose, be defeatedto be under an obligation

짓	act, behavior

명사	noun
위험하다	to be dangerous, risky
동네	neighborhood, village
좌석	seat
제발	pleaseby all means

찾아가다	to visit

시절	years (college years etc.), period of life
종일	all day long
정류장	stop, station (bus etc.)
취직하다	to get a job
덜	less
둘이	two people

미치다	to go mad, crazyto reach

선배	senior (often at the same education- or workplace)
지역	area, region
알리다	to inform, let know, notify

용돈	pocket money, allowance
법	law
작가	writer
가능하다	to be possible
심장	the heart (in the body)
인형	doll, puppet
기사	news articledriver, chauffeurengineer
잊어버리다	to forget (completely)

펜	pen

솔직히	honestly, frankly
순간	moment, instant
원하다	to want, wish, hope
월급	monthly salary
주제	subject, theme, topic
열리다	to be open, be opened

피	blood

식구	family, member of family
휴대전화	cell phone (2)
확인하다	to confirm, verify
관심	interest, concern
바보	fool, stupid person

숨다	to hide, disappear

상처	injury, wound, bruise
차이	difference
절대로	neverabsolutely, completely
젖다	to get wet, soaked, be moistened

놈	guyjerk

일단	once [something has happened]first (of several actions)for now
양복	suit
방송하다	to broadcast
중심	center, core, balance
결과	result
배부르다	to have a full stomach

출장	business trip
숲	forest

원래	originally, primarily
닮다	to resemble, be alike

한자	Chinese character
추위	cold weather

아시아	Asia

죽이다	to kill, murderto hold back, suppress

귀걸이	earring

책임	responsibilityblame
실례	bad manners, rudeness
깨지다	to be broken, get broken

환자	patient (medical)
미리	in advance

왜냐하면	because, since

대다	to place, putto feel, touch

인상	impression
동쪽	the east
대신하다	to take the place of, act as a substitute
세탁기	washing machine
바닥	floor, the bottom

그대로	as [it] is, intactly

뛰다	to jumpto run, dash

반대	reverse, opposite
지방	local area, regionfat
호랑이	tiger
부지런하다	to be hardworking, diligent

댁	[your] house (hon.)
역시	too, alsostill
대학생	college student
뵙다	to see, meet (hon.)

습관	habit
건너편	the other side
대사관	embassy
생각나다	to come to mind, think of, remember

군인	military personnel, soldier
식탁	dining table
남학생	male student
구하다	to look for, seekto rescue, save
여권	passport
테니스	tennis
갈색	light brown
젊다	to be young, youthful

광고	advertisement
경치	scene, scenery
찌개	stew
두껍다	to be thick, heavy

치약	toothpaste
경찰관	police officer
군대	army, troops
노트하다	to take notes

제목	title, name
가습기	humidifier
시대	period, era
위하다	to do for the sake of, on behalf of
샌드위치	sandwich

기업	enterprise, business
이상	more than, aboveabnormalityideal
꿈꾸다	to dream

모래	sand

결혼식	wedding ceremony
회색	gray
닿다	to reach, touch

활동	activity
대단히	very much, greatly, highly

인간	human being, mankind
움직이다	to move

쉽게	easily

정답	correct answer
여학생	female student
부끄럽다	to be shameful, disgraceful, ashamedto be shy

아래층	downstairs
따로	separatelyin addition

비밀번호	password, PIN
집다	to pick up

소녀	young girl
번역	translation
기계	machine
자연스럽다	to be natural
바닷가	beach, seaside

땀	sweat, perspiration

수영복	swimsuit
걸어오다	to come by foot

공짜	free (of charge)
고개	head, neck

데리고가다	to bring someone to some place

해외	foreign country, overseas
출구	exit
추워지다	to become cold

모델	model

수첩	(pocket) notebook, personal organizer
경험하다	to experience
당장	on the spot, immediately
상품	prizeproduct, goods
세계	the world
선택하다	to choose, select
사촌	cousin
주로	mostly, mainly
키스	kiss

모으다	to collect, gather up

저번	last time, the other day
분홍색	pink
들리다	to be heard, to hearto be lifted, be raised

떡	Korean rice cake

얼른	promptly, right away, quickly

심각하다	to be serious, grave, severe
손목	wrist

라디오	radio

계산하다	to calculate
다행히	fortunately
자식	one's children
넘다	to exceedto climb (over)

원숭이	monkey

가요	song
높이	heighthigh, highly

올라오다	to come up

드디어	finally, at (long) last

개인	individual
공휴일	legal holiday, bank holiday
신나다	to be excited

별일	special event, unusual occurence
기술	skill, techniquedescription
자랑하다	to be proud (of), boast (about)

사계절	four seasons
전체	the whole, entire
취소하다	to cancel, withdraw
느리다	to be slow

조사	investigation, inquiry, surveypostpositioneulogy
바라다	to desire, wish, hope
새해	New Year

국제	international-
소개팅	blind date
정확하다	to be exact, correct, accurate
프로그램	program

표정	facial expression
공무원	public servant, government employee
신기하다	to be marvelous, wonderful, amazing
국물	soup, broth

대부분	greater part, mostly
민족	people, ethnic group
전공하다	to major in, specialize in
러시아	Russia

짐	load, burden, luggage, cargo

완전히	completely, entirely, fully
식다	to cool off, get cold

국수	noodles

현금	cash
조카	nephew, niece
환영하다	to welcome (somebody)
이메일	email

제대로	appropriately, properly

사자	lion
빼다	to pull out, extractto subtract

자료	materials, data
무게	weight

대통령	president (of a country)
지루하다	to be boring
분명히	clearly, distinctively
장학금	scholarship
고통	pain, suffering
찾아오다	to come see someoneto retrieve something

악기	musical instrument
식품	food items, groceries
세기	century
큰일나다	to be in big trouble

놀이	play, game, pastime

평일	weekday
기회	chance, opportunity
없어지다	to lose, be lostto disappear
메모	memo, note

열	fever, heatrow, line, queue
발전	development, growth
검사하다	to examine, inspect
대구	Daegu
마당	yard, garden

소년	young boy
흐르다	to flowto overflowto elapse

우선	first of all
생명	life, soul
잔돈	change (money)

주차하다	to park
짧게	briefly

남	other people

예약	reservation, booking
아쉽다	to be sorry, sad

배구	volleyball
역할	role, part
빨강	red

따라오다	to follow, come with

여성	women
양파	onion
행동	behavior, action
웃기다	to amuse, to be funny
국내	inside country, domestic
겁	fear, fright
모양	shape
말리다	to dryto make somebody stop doing something

고모	aunt (father's sister)
옷걸이	coat hanger

기간	period, term
관련하다	to be related to, connected with
꿀	honey

아무래도	anyway, by the look of (it)by any means

능력	ability, capability
깊다	to be deep

마을	village, town

크게	greatly, highly

비서	secretary
특별하다	to be special, extraordinary
금년	this year
교환학생	exchange student
멈추다	to stop, cease
대표	representative
녹차	green tea
도움	help, aid

지각하다	to be late (for something)to perceive, sense, be aware
딱	exactly, precisely

향수	perfume, fragrancehomesickness
반드시	surely, certainly

비키다	get out of the way, step aside

탁자	tea table
상황	situation, state of things
십대	teenage, teenager
익숙하다	to be familiar, used to something

여보	Honey, Dear

고장	defect, break down
마디	knuckleword

포기하다	to give up
예술	art
적어도	at least

임금	wages, payking, monarch
모자라다	to be insufficient

희망	hope
세계적	global, worldwide
호선	[subway] linearc, curve
빠지다	to fall intoto fall out, come off

막내	youngest child (in a family)

인천	Incheon
가능성	possibility, likelihoodpotential
약하다	to be weak
대회	mass meeting, conventioncontest, tournament (where many people gather)
커피숍	coffee shop

방향	direction
다하다	to run out, be used up, become exhausted

미소	smile
단체	organization, association
어쨌든	anyway, in any case

넘어가다	to cross, go overto fall into, go down

주황색	orange
근무	service, work, duty
선수	player, athlete
간단하다	to be simple, easy
바깥	outside

이혼	divorce
제품	product, manufactured goods
변화하다	to change, alter
사업가	businessman
공중	publicthe air, space
비다	to be empty, vacant

주변	surroundings
판매	sale
잠들다	to fall asleep
등산	hiking, mountain climbing
자꾸	constantly, repeatedly

공포	fear, scare
쌓이다	to pile up, be stacked up

주부	housewife
전쟁	war
스트레스	stress

편안하다	to be comfortable, relaxed, peaceful
마찬가지	the same, identical, equal

현대	the present age, modern times
그림자	shadow

밀다	to push, shove

효과	effect, efficiency
지붕	roof

긴장하다	to be nervous, be tense
정원	capacity, limitgarden
너머	beyond, the other side

천사	angel
놓치다	to miss, let slip, fail to catch

배낭	backpack
쥐	ratmouse

끌다	to pull, draw

휴지통	trash can, wastebasket
경주	race, runGyeongju
국민	people, citizen
나타내다	to expressto show, display

기말	end of a term, end of a semester
괜히	in vain, pointlessly, for nothing

참외	oriental melon

다양하다	to be various, diverse
무릎	kneelap

질서	order, system
지우개	eraser, rubber

담다	to put into

시민	citizen
점점	gradually, little by little, increasingly
비교하다	to compare with
칫솔	toothbrush
종류	kind, type, sort
한식집	Korean restaurant
바라보다	to look at, watch, gaze

가죽	leather

기름	oilfat

인사동	Insadong

알려지다	to become known

화장	make-upcremation
우편	mail, post
멀리	far, far away

상상하다	to imagine
음악회	concert
표현	expression (verbal, grammatical etc.)
이웃	neighbor

반대하다	to oppose, be against
보라색	violet, purple
공간	space, room
당시	at that time, in those days
안내하다	to guide, lead the way
크기	size, volume

한편	one side, one handmeanwhile
태국	Thailand
갈아입다	to change clothes

육교	pedestrian overpass
편히	conveniently, comfortably
코멘트	comment

강조하다	to stress, emphasize
시설	establishment, facilities
남산	Namsan, Mt. Nam (in Seoul)
차례	order, sequencetime, turn
싱겁다	to be bland, not salty enough

벌	punishment, penaltybee
재산	property, fortune, wealth
가져가다	to take (along), carry

공장	factory
아무리	however, no matter how
이모	aunt (mother's sister)
요구하다	to demand, ask, claim
아픔	pain, achesorrow, grief

쌀	uncooked rice

일반	general, common
떠들다	to make noise, speak loudly

전국	the whole country
금방	shortly, soon, any minute
창피하다	to be ashamed, embarrassed
가정	home, familysupposition, assumption
책장	bookshelf, bookcasethe page of a book
더하다	to add (up), sum upto get worse, grow harder

늘	always, all the time

의견	opinion, view, idea
맞추다	to set, adjust

꽃병	flower vase

문자	letters, alphabettext message
과장님	head of department, chief
섭섭하다	to be sorry, disappointed, regret

몰래	secretly

설날	New Year's Day

얼음	ice

참가하다	to participate, join
형제	brothers, siblings
화분	flower pot
나누다	to divide, split upto share

불만	dissatisfaction,complaint
최대	the largest, the biggest
갈아타다	to change vehicles, transfer
발목	ankle

자체	oneself, itself
정리하다	to arrange, put in order
태도	attitude, manner
믿음	belief, trust

데려오다	to bring, go and get, fetch someone

신용카드	credit card
청색	blue
주장하다	to assert, contend, insist
한숨	sighrest, pause

남성	men, malemasculine gender
확실하다	to be certain, be reliable
삼촌	uncle
도로	road, street
세다	to be strongto count (up)

만두	dumpling
이틀	two days

실패하다	to fail, go wrong
재료	material, ingredient
복	blessing, fortune
인정하다	to admit
전문	specialty
고민	worry, trouble
뜻하다	to mean, signifyto intend, plan, aim

고객	customer, client

요새	these days, currentlyfortress
질리다	to get tired, sick of

원피스	dress

사정	reasonsituation, circumstances
방해하다	to disturb, interrupt
무언가	something

자유	freedom, liberty
떨어뜨리다	to drop (something)
정문	the front gate, main entrance
시골	country, rural area

자세히	closely, in detail
좌회전하다	to turn left
유럽	Europe

푹	deeply, soundly, carefully

옮기다	to move, transfer

국가	state, nation
크리스마스	Christmas

신혼여행	honeymoon
자라다	to grow up, be raised

지구	Earth, globedistrict, zone
골프	golf

해결하다	to solve a question, problem
소비자	consumer
한라산	Mt. Halla
스키	skiing, skis
바뀌다	to be changed, transformed

포장	packing, wrapping
환경	environment
진행하다	to progress, proceed
빗	comb

신분증	ID card
맡다	to take charge of, undertaketo smell, sniff, scent

문구	stationeryphrase, sentence
과목	subject, course
특별히	especially, particularly
지르다	to yell, shout, scream

그대	you (poet.)

남색	indigo, deep blue
쌓다	to pile upto accumulate

마음속	one's mind, one's heart

직행	going straight, going direct
불쌍하다	to be pitiful, pathetic, poor

수염	beard, moustache, whiskers
대본	script, screenplay
졸다	to doze off
오토바이	motorcycle

절대	absolutely, definitely
끓이다	to boil, heat, cook

계산서	check, bill
팬	fan (a person)

고백하다	to confess, admit
옥수수	corn

각종	every kind, various kinds
돌리다	to turn, spin
실력	skill, ability
모기	mosquito

낳다	to give birth

전자의	electronic
치과	dentist
관광	tourism
늘다	to increase, grow, rise

과정	process, course
동물원	zoo
차다	to kickto be cold, chillyto be full (of)
땅	the groundland

예정	schedule
상관없다	to not matter, not careto have nothing to do with
자격	qualification
신촌	Sinchon

사오다	to buy something and bring it

일부러	intentionally, on purpose

전철	subway (train)
마치다	to finish, complete

호	a number (count.)issuearc
행사	event
감동하다	to be moved, touched (emotionally)
큰일	serious matter

상태	condition, state
잇다	to connect, join
검정	black

왠지	somehow, for some reason

기온	temperature
모이다	to come together, assemble, gather

정부	government
햇살	sunlight, sunshine

녹음하다	to record (sound etc.)
연휴	long holiday, consecutive holidays
과제	task, assignment
우회전하다	to turn right
경쟁	competition
흙	earth, soil
깨다	to breakto wake (up)

금속	metal
일기	diary, journal
나서다	to leave, set outto come forward<br />to meddle

계약	contract
빛	light, ray, glow

대학원	graduate school
발견하다	to discover, find
뒷문	back door
공기	air
누르다	to press down, push down, to suppress
정거장	station, stop
특징	distinguishing mark, characteristic
돌려주다	to give back, return something
오히려	rather, preferably

연예	entertainment
삶	life

합격하다	to pass an exam
동시에	at the same time
속옷	underwear

현실	actuality, reality
완전하다	to be perfect, complete
미역국	seaweed soup

답	answer
내밀다	to stick out, extend

발표	announcement, presentation
꽃집	flower shop

마련하다	to prepare, arrange

기본	basis, foundation, basics
쌍둥이	twins
흔들다	to shake, wave, swing

감정	feeling, emotiongrudge, animosityappraisal, valuation
음악가	musician
취하다	to get drunk, be drunkto choose, pick, take
그룹	group

대중	the (general) public
고생하다	to suffer, have a hard time, have trouble
기초	foundation, basis, base
혀	tongue

떨다	to tremble, shake, vibrate

전통	tradition
이미지	image

상자	box
신청하다	to apply for, request
금발	golden hair
안주	appetizers served with drinks
가만히	still, motionlessly

깜빡하다	to forget, slip one's mind

막	just, just nowseverely, carelesslycurtain
전기	electricitybiography
하양	white, whiteness

물다	to biteto pay (for)
위치	position, location, site
마침내	finally, eventually, at last

기르다	to raise, look afterto grow
버릇	habitmanners

태양	sun
학습	studying, learning
답답하다	to feel frustratedto be stuffy

검	sword
새로	newly

의심	doubt, suspicion
줄이다	to reduce, decrease

덕분에	thanks to
장점	advantage, strength, strong point
여우	fox

부족하다	to lack, be lacking, not good enough
욕조	bathtub
짜증	irritation, annoyance

달라지다	to change, alter, vary
회장	president, chairmanhall, venue
모임	meeting, gathering

인삼	ginseng
기대하다	to expect, look forward
웃음	laughter, smile

성인	adult, grown-up
각각	each, every
보호하다	to protect
터	site, ground

주먹	fist

그치다	to stop (doing), cease
신사	gentleman
때때로	occasionally

수저	spoon and chopsticks (traditional Korean utensils)

훌륭하다	to be excellent, great, superb, fine

드레스	dress

산업	industry
낡다	to be old, worn

큰형	boy's eldest brother
도둑	thief

못생기다	to be ugly, unattractive

회식	dining together (among colleagues)
코피	nosebleed
시도하다	to try, attempt
이상형	ideal type
실내	indoors
막다	to block, close

매년	every year
남방	shirtsouth
알아듣다	to understand, catch, see

풀	grassglue

수입	incomeimport
푸르다	to be blue, green

목장	farm, ranch
죽음	death

엊그제	a couple of days ago

오래되다	to be old (for an object)

하숙집	boarding house
무	radish

노약자	old and/or weak people
완벽하다	to be perfect, flawless
명령	order, command
신호등	traffic light
키우다	to raise, bring up, breed

흔히	commonly, frequently, generally

티셔츠	T-shirt

느껴지다	to feel (as if)to be impressed, be moved

주요	major, main, primary
및	and, as well as

내놓다	to put out, take outto show, present

목표	target, goal
노인	old people
변호사	lawyer
칭찬하다	to praise, compliment
욕심	greed
즉시	at once, immediately, without delay
썰다	to cut (up), chop, slice

음료수	beverage, drink
소포	parcel, package
평화	peace
개다	to fold upto clear up

어젯밤	last night
비용	expense, cost
서두르다	to hurry up, hasten

평생	lifetime, one's entire life
명절	(national) holiday
이르다	to arrive, reachto be early, prematureto tell, say

오른손	right hand

상추	lettuce

늙다	to grow old, be old

전문가	expert, specialist
기준	standard, criteria
이불	comforter, bedding

늘어나다	to grow longerto increase

고구마	sweet potato

형태	form (more abstract)
방문하다	to visit
단점	weakness, flaw, shortcoming
무역	trade, commerce
그립다	to be missed, be belovedto miss, long for

마음대로	as one pleases, at one's convenience

장남	eldest son
살려주다	to save, rescue, spare

명함	business card
세금	tax
판단하다	to judge, decide, make a judgement
신체	body
박수	handclapping, applause
익숙해지다	to get used to

충격	shock
강남	Gangnam
위로하다	to console, comfort
제공	offer
하늘색	sky blue

들르다	to stop by

기념	commemoration
스케이트	skates

과음하다	to drink too much
수술	operation, surgery
잡채	noodles with sauteed vegetables
볶다	to fry, roast

배경	background, setting
한강	Han River
구입하다	to purchase
편도	one-way trip
여행사	travel agency
충분하다	to be enough, be sufficient
무용	dance
낙엽	fallen leaves
쳐다보다	to look (at), stare (at)

연기	acting, performancesmoke
손잡이	handle, knob

넘어지다	to fall (down)

나비	butterfly

콘서트	concert

무시하다	to ignore, disregard
기관	engineinstitute, schoolorgan
선풍기	electric fan
옳다	to be right, correct, proper

잔치	party, feast

물음	question

통하다	to go through, flowto be circulatedto be understood
영화관	movie theater
자막	subtitlescaption
달려오다	to come running

드라이어	dryer

각자	each one, each
다가오다	to approach, come near

글씨	letter, character (handwritten)
온도	temperature
손바닥	palm of the hand

향하다	to face, look out atto proceed to, lean towards
방식	method, manner, way
가짜	imitation, fake
속하다	to belong to
월말	end of the month
식후	after a meal
입장하다	to enter, get into, obtain admission
영향	influence, effect
주머니	pocket, bag

장난치다	to joke, kid, frisk, get funny (with)

거미	spider

개인적	personal, individual
심하다	to be heavy, severe, harsh
금연	smoking prohibited, no smoking
주인공	protagonist, main character
기도하다	to prayto attempt
나머지	the rest, the remainder

주위	the circumference, perimetersurroundings
살피다	to look over carefully

적극적	positive, active
눈치	reading (sensing) the atmosphere or people's faces

개발하다	to develop, improve
젊은이	the youth, young person
점차	gradually, little by little
끄덕이다	to nod

길이	length

천둥	thunder
높이다	to raise, make higher

형님	a man's older brother (hon.)
사물	objects, things, matters
독서하다	to read books
곰	bear

신부	brideCatholic priest
쪽팔리다	to be embarrassing

찬물	cold water

일반적	general, usual
놓이다	to be putto feel relieved

밤색	brown,chestnut
감히	boldly, daringly
발생하다	to occur, arise, happen
에너지	energy

새끼	young animalfellow

괴롭다	to be painful, distressing

소문	rumor, gossip
이리	wolfhere, this way

참석하다	to attend, be present
걸음	step

방송국	broadcasting station
가늘다	to be thin, slender

똑바로	straight, directlyhonestly, frankly

통장	bankbook
화내다	to get angry, vent one's anger
서양	the West
콩	bean

안전하다	to be safe, secure
시인	poet
단계	stage, phase, step
가리다	to cover, hide, shieldto distinguish, differentiate

할인	discount
고추	chili pepper

심다	to plant

계산기	calculator
전기밥솥	electric rice cooker
지치다	to be exhausted, worn out

글자	letter, character
마침	coincidently, just

교사	instructor, teacher
뻔뻔하다	to be shameless, brazen
이전	the previous, before, formerlyrelocation, move
몸살	body ache

찾아보다	to look for, search

종교	religion
진지	meal (hon.)position, stronghold
서운하다	to be sad, hurtto be regrettable

예절	manners, etiquette
밤새도록	all night long

통화하다	to talk over the telephone
뱀	snake

교육	education
견디다	to bear, endure, tolerate

혼자서	by oneself, to oneself, in solitude

연애	datinglove, romance
뿌리다	to sprinkle, spray, scatter

연두색	light green
전화번호	phone number
외교	diplomacy
알맞다	to be fitting, suitable, appropriate

만남	meeting

문서	document, papers
붙이다	to stick, attach

금	goldline
한참	for some time

가리키다	to point to

저리	that way, that directionlow interest (rate)
추억	recollection, remembrance
안타깝다	to be heart-breaking, frustrating, regrettable

부장	head of department
양식	style, patternWestern-style foodgood senseculture, farming
어둠	darkness

진하다	to be darkto be thick, strong, rich
박사	doctor, expert
후추	black pepper

혼나다	to be scolded, have a hard time
껌	chewing gum

팝송	pop song

단지	simply, merely, justapartment complex
가득하다	to be filled (with)

형용사	adjective
부자	rich personfather and son
모시다	to accompany, taketo treatto serve (hon.)

낮잠	nap

토끼	rabbit

발달하다	to develop
직원	employee, staff member
매력적	attractive, charming
수많다	to be numerous, a lot of
깜짝	startling

마늘	garlic

연하다	to be soft, light, tender
너희	you (plural)

고속버스	express bus
끼다	to be caught (in), be involvedto wearto cloud over, be foggy

우연히	by chance, accidentally
손수건	handkerchief
늘리다	to increase, addto extend

목욕탕	bathroom, bath house
그리	so, verythere, that way

뽑다	to pick, draw, pull out

체육	physical education
곡	tune, music, song
불리다	to be called, be invitedto enrich oneself

교포	ethnic Korean living abroad
도시락	(packed) lunch

싸움하다	to fight, quarrel

오징어	squid, cuttlefish

수도	capital citywater supply (service)
퇴원하다	to be discharged from the hospital
주민	resident, inhabitant
몇몇	some, several

순수하다	to be pure, genuine
명동	Myeong Dong
논문	thesis, research paper
양	quantity, amountsheep, lamb
차리다	to set, prepareto pull oneself together

식물	plant, vegetation
맨날	always, every day (<i>less formal</i>)
이익	profit, gain, advantage
잡히다	to be caught, be grabbed

어려움	difficulty, hardship

온	all, entire, whole

바르다	to apply, put on

오랫동안	for a long time

농촌	farm village
잘되다	to be going well, come out well

전부	all, entire, total
한쪽	one side, one way

용서하다	to forgive
검사	prosecutor, district attorneyexamination, inspection, check
그만큼	that much, to that extent

후회하다	to regret
치료	treatment, cure
찻잔	teacup
쥐다	to grip, clench, grasp

고모부	father's sister's husband
정상	normalitytop, summit
벌어지다	to get widerto happen, break out

막차	the last train/bus
욕	swear word, insult, abuse
포함하다	to include, contain
노동	labor
가치	value, worth
커지다	to grow big, expandto become serious

시리즈	series

분석	analysis
날아가다	to fly away

얼다	to freeze, be frozen

폭	width, rangedeeply, completely
서류	documents, papers
울리다	to ringto make someone cry

부동산	real estate, property
수필	essay
속이다	to deceive, cheat, trick

주유소	gas station
최선	the best
의지하다	to rely, depend, lean on
조상	ancestor, forefather
곁	side, beside

불가능하다	to be impossible
선반	shelf

세월	(long period of) time
비우다	to empty, vacate

승무원	crewman, stewardess
대체	(why) on earth, (what) the hellsubstitution
입학하다	to enter a school, be admitted into a school
꼬리	tail

밭	field, farm

꾸다	to dreamto burrow

퇴근시간	closing time
자세	posture, position
담기다	to be put in, be included

상대방	the other party, the opposing team, adversary
기능	functionskill
줍다	to pick up, gather up

강물	river water
문제점	problem, drawback, the point in question
동의하다	to agree
샴푸	shampoo

정장	formal wear (outfit, dress, suit)
꾸미다	to decorate, make upto invent, prepare

깊이	depthdeeply

성공	success
마주보다	to look at each other

일식	Japanese-style foodsolar eclipse
겨우	barely

젓다	to stir, whipto rowto gesticulate
비교적	relatively, comparatively
예술가	artist
이루다	to achieve, accomplishto make, form

농사	farming
몹시	extremely, awfully, very

신선하다	to be fresh
최초	the very first
시선	one's eyes
상하다	to go bad, spoilto be hurt
즉	namely, so to speak
과학자	scientist
씹다	to chew
한두	one or two

파리	flyParis

허락하다	to allow, permit
질투	jealousy
볼	cheekball

연기하다	to delay, postpone, put offto act
구멍	hole

서비스	service

그만두다	to quit (work, school, etc.)to give up (drinking etc.)

왼손	left hand

이리저리	here and there, this way and that

숨기다	to hide, conceal

햇볕	sunbeam, sunlight

총	guntotal, overall
기록하다	to record, write downto register
회원	member, membership
춘천	Chuncheon
신고하다	to report, declare, notify
영원히	forever, eternally
검색	search
활용하다	to utilize, put to practical use
세탁소	laundry, dry cleaner's
밀가루	flour

반복하다	to repeat
송이	counter for clusters of grapes, bunches of flowers and similar

집안	home, family, household

환전하다	to exchange money
청소년	teenager, youth, adolescent
미역	seaweed, sea mustard

가꾸다	to grow, cultivateto take care of

의학	medicine, medical science
우주	universe
피다	to bloom, blossomto burn

함부로	thoughtlessly, carelessly

교문	school gate
싣다	to load (up)
생년월일	date of birth
감옥	jail
표시하다	to mark, indicateto express, show
중요성	importance, significance
차비	transportation fare
금지하다	to prohibit, ban
절	Buddhist templedeep bowclause, verse
제법	pretty, fairly, quite

살펴보다	to look around, watch for

온돌방	room with the Korean floor heating system
번개	lightning

일정하다	to be fixed, constant, regular
안내	guide, information leaflet
마치	as though, as if

헷갈리다	to be confused, confusingto be hard to find

선글라스	sunglasses

거품	bubble, foam

채우다	to fill upto lock, fasten

식빵	bread
통일	unity, unification
교환하다	to exchange, trade
오리	duck

이동	movement, transfer
너무하다	to be unreasonable, too much

손자	grandson
친척	relatives
연결하다	to connect, link, attach
페이지	page

된장	soybean paste
신랑	groom
속상하다	to be upset, distressedto be upsetting, distressing
대표적	representative, typical
후배	one's junior (at school or workplace)
감상하다	to enjoy, appreciate
누구나	anyone

복도	hallway
정하다	to decide, determine, choose
성냥	matches

기타	guitaretc.
실망하다	to be disappointed
불교	Buddhism
집사람	wife

잦다	to be frequent

날개	wings

오페라	opera

불완전하다	to be incomplete, imperfect
미술	art
김	dried seaweedsteam

편찮다	to be unwell, sick
심부름	errand

복수	revengeplural
비하다	to compare to
땅콩	peanut

한발	one step

부치다	to mail, shipto fry

공중전화	public phone
손녀	granddaughter
선선하다	to be cool, refreshing

캠퍼스	campus

학위	academic degree
얇다	to be thin, flimsy

소	cow

노랑	yellow

생겨나다	to come into existence, occur

만일	in case, by any chance, suppose
종합	synthesis, putting together
응원하다	to cheer, support
사회적	social
빌딩	building

틀림없다	to be certain, beyond a doubtto be trustworthy

스스로	oneself

왼편	the left side
달려가다	to run, dash, rush

고속도로	expressway, highway
관객	audience, spectator
우울하다	to be gloomy, cheerless, depressed
농업	agriculture
블라우스	blouse

맡기다	to leave something with someone,to entrust, deposit

눈병	eye disease
속도	speed, pace
놀랍다	to be surprising, startlingto be wonderful, marvelous

냄비	pot, saucepan

프로	professional

예매하다	to book, reserve, buy in advanceto sell tickets in advance
딴	other, different

유난히	unusually, exceptionally

화려하다	to be splendid, gorgeous
귀고리	earring

시청자	viewer, TV audience
적당하다	to be appropriate, suitable, moderate, proper
그늘	shade

사은품	free gift
다리다	to iron, press

종	speciesbellslave, servant
최소한	at the (very) least
장보다	to go to market, go grocery shopping
요청	request, demand
예식장	ceremony hall, wedding hall
차지하다	to take possession, occupy
흥미	interest
입구	entrance, gateway
살리다	to save one's life, spareto make good use

트럭	truck

개성	personality, individuality
숨쉬다	to breathe

지하도	underpass
원인	cause, factor
이루어지다	to come trueto be formed, consist (of)

청소기	vacuum cleaner
지식	knowledge, understanding
굵다	to be thick

도표	diagram, chart
간절히	earnestly, eagerly, sincerely
깨닫다	to realize, recognize
해수욕장	swimming beach
인구	population
흘리다	to spill, shed (tears, blood etc.)

커튼	curtain

가로등	street lamp, street light
붓다	to pour (into)to become swollen

음식점	restaurant
대박	jackpotsomething great

전학가다	to change schools
법원	court (of law)
뿌리	root

배탈나다	to have a stomachache
이천	Icheon
매표소	ticket booth
구조하다	to save, rescue
병실	hospital room, ward
눈썹	eyebrow

노크하다	to knock

실제로	in fact, actually
낚시	fishing

건지다	to take out of waterto take back

플랫폼	platform

다방	tea room, coffee house
끓다	to boil, simmer

품목	item, goods
골목	alley

챙기다	to gather, pack, put things in orderto take care of

매달	every month
독감	flu
붙다	to stick to, adhere to

시어머니	mother-in-law (of a woman)
핑크	pink

당하다	to experience, encounter, suffer
운전사	driver, chauffeur
고급	high rank
풀리다	to get solved, get loose, be relieved

동아리	club, society, group

학자	scholar
커다랗다	to be very big, huge

연락처	contact information
책꽂이	bookshelf
쏟다	to spill, pour

바닷물	seawater

약도	rough map, sketch map
매다	to tie, bind

뮤지컬	musical

게으르다	to be idle, lazy

진찰	medical examination
배드민턴	badminton

건너가다	to cross, go across

옛날얘기	folk tale, legend

그제	day before yesterday

삼다	to adopt, use a thing as

머리카락	hair

부사	adverb
드물다	to be rare

깨끗이	cleanly, neatly

유치원	kindergarten
떨리다	to tremble, shake, shiver

동남아시아	Southeast Asia
액자	picture frame
서투르다	to be unfamiliar (with), unskilled, poor (at)

동양	the East
미용실	beauty salon, hairdresser's
밟다	to step onto trail after

요금	charge, fee
소방서	fire station
놀리다	to tease, kid, make fun ofto leave something idle, unused

돌	stone, rockfirst birthday

서랍	drawer

없애다	to remove, get rid ofto waste

맞선	marriage meeting, blind date

사모님	one's teacher's wife,one's superior's wife
벌주다	to punish

점수	score, mark, grade
엄청	very, very much

문병가다	to visit a sick person
런던	London

집들이	housewarming party

털다	to dust off, brush offto rob

분실물	lost article, lost item
매진	sold out, sellout
보여주다	to show, display

훈련	training, practice
이태원	Itaewon

미끄럽다	to be slippery

시험지	test paper
똑같이	equally, evenly

예상하다	to forecast, anticipate, expect
식혜	sweet rice drink
테이프	tape

붉다	to be red, crimson
눈앞	in front of one's eyes, just ahead

주택	house, housing
캄캄하다	to be dark, pitch-black

대학원생	graduate student
순서	order, sequence, procedure
시다	to be sour

이하	below, less than
음	sound, toneyin
빠져나가다	to escape, slip away

구체적	concrete, definite, specific
파도	waves
깨우다	to wake someone up

색연필	colored pencil
교장	principal, headmaster
팔리다	to be sold, be in demand

신혼부부	newly wed couple
예외	exception
지나치다	to pass by, go pastto go too far, be too much

어차피	anyway, in any case
스케줄	schedule

바람나다	to have a secret love affair

통신	communication, correspondence
센터	center

외출하다	to go out
역사적	historical
부족	tribeshortage, lack
옥상	rooftop
아깝다	to be precious, valuableto be regrettable, pitiful

의지	will, volition
무조건	unconditional
쫓다	to chase, pursue

기적	miraclesteam whistle
콧물	snot, nasal mucus
감동받다	to be impressed
동료	colleague, co-worker
아이디어	idea
솔직하다	to be frank, honest, candid
게다가	besides, on top of that

목도리	scarf

파	green onion

힘세다	to be strong, powerful

붕대	bandage, dressing
리모콘	remote control
어색하다	to feel awkward, be at a loss for words
촬영	shooting, filming
오죽	very, indeed, how

보고하다	to report, inform
달리	differently

예금	deposit, savings
어느새	in no time, quickly

먹이다	to feed, let someone eat

빵집	bakery

창고	warehouse, storage
고동색	reddish brown
등록하다	to register, enroll
멍청이	stupid person

손톱	fingernail

단순하다	to be simple
살짝	slightly, gentlyin secret, by stealth

가스	gas

발걸음	step, pace

만족하다	to be satisfied, pleased
영수증	receipt
인물	person, individual, character
관찰하다	to observe, watch
책방	bookstore
대전	Daejeon
재벌	conglomerate, plutocrat
감소하다	to decrease, decline
변기	toilet
다만	only, merely

수다떨다	to chitchat

비둘기	pigeon

여왕	queen
황금	gold
저금하다	to save money, make a deposit
액션	action

삼계탕	chicken soup with ginseng
죄	crime, sin, blame
자유롭다	to be free
대학로	Daehangno
선착순으로	by order of arrival
명성	reputation, fame
고정시키다	to fix, fasten, immobilize
주사	injection, shot
답장	response, answer (written)
지은이	writer, author

임신하다	to be pregnant
곤충	insect, bug
심리학	psychology
까닭	reason, cause, grounds (for)

따라다니다	to follow (somebody around), to chase

개미	ant

기념일	anniversary
압력	pressure
나빠지다	to grow worse

자녀	children
아프리카	Africa

철	iron, steelseasondiscretion, [good] sense
대기하다	to stand by, be waiting
최종	last, final
독립	independence
미끄럼	slide, sliding

이어지다	to be connected, be continued

전경	panoramathe front view
구석	corner

호기심	curiosity
다가가다	to approach, go near

교재	teaching materials
미용	beauty treatment
좀처럼	rarely

시합하다	to play against, have a game
작품	piece of artwork
유감	regret
급행열차	express train
한가하다	to be free, have leisure, have time to spare
오해	misunderstanding
티켓	ticket

상세	details, particulars
치우다	to tidy up, clean up, remove

웨딩드레스	wedding dress

마감	deadline

보험	insurance
때리다	to beat, hit, attack
건너	across

실외	outdoors
기후	climate
이발하다	to get a haircut (for men)
식	form, styleceremony
무대	stage
관악산	Mt. Gwanak
소중하다	to be valuable, important, precious
가사	lyricshousework, chores
집안일	housework, housekeepinghousehold affair

약혼	engagement (before marriage)
언짢다	to be upset, displeased

결말	ending, finish, conclusion
아리랑	traditional Korean song Arirang

구좌	(bank) account
보장하다	to guarantee
홍콩	Hong Kong

민속촌	Folk village
어휘	vocabulary
희한하다	to be strange, odd, unusual, rare
만년필	fountain pen
그네	swings

합계	sum, total
감다	to wind, rollto washto close one's eyes

광주	Gwangju
횡단보도	crosswalk
환대	hospitality, [warm] welcome
여전하다	to be unchanged, be as usual
빗물	rainwater

집집마다	every house

네모	square

독하다	to be potent, strongto be spiteful
영혼	soul
객실	roomcabin
호주머니	pocket
허전하다	to feel empty, lonesome

모험	adventure
빈칸	blank column

머무르다	to stay, remain

시제	tense (grammatical)
즐겁게	pleasantly

섞다	to blend, mix

장난감	toy

매점	snack stand, booth
다이어트	diet

걸어다니다	to walk, walk around

물가	cost of living, prices
중고품	used article, secondhand goods
느끼하다	to be greasy, oily, rich
돌잔치	celebration of a baby's first birthday

과외	extracurricular work
잠기다	to be locked, be fastenedto be submerged, go down

선택권	option, choice
운	luck, fortune, fate
국기	national flag
경고하다	to warn
별것	something peculiar
다리미	clothes iron

토론	discussion, debate
바치다	to dedicate, offer, give

샌들	sandals

승용차	passenger car
화산	volcano
운반하다	to transport, carry, convey
천장	ceiling
온라인	online

작동	operation (of a device)
지원하다	to support, backto apply, volunteer
몫	share, portion

노동자	worker, laborer
논리	logic
빚내다	to borrow money

비상	emergency -
장비	equipment, gear
계획표	written schedule
무서워하다	to fear, be afraid

성장	growth
차라리	rather, preferably

지옥	hell
일어서다	to stand up

소아과	pediatrics
약사	pharmacist
감독	supervisionsupervisor, director
회전하다	to turn, rotate, spin
외투	overcoat
디자인	design

원장	director
빛나다	to shine, gleam, be bright

야만적	uncivilized, savage
주급	weekly pay [salary]
망설이다	to hesitate, be hesitant

전원	countryside, rural areaselectricity supplyall members, everyone
용기	couragecontainer
당분간	for the time being, for a while
어마어마하다	to be tremendous, immense, grand

정각	the exact time (not sooner or later)
형사	detective
덕수궁	Deoksu Palace
무너지다	to collapse, cave in

천국	heaven, paradise
구독	subscription
사생활	privacy, private life
제안하다	to propose, suggest
정직	honestysuspension
면접	interview
어쩌다가	by chanceonce in a while

다듬다	to trimto refine

무척	very much

범인	criminal, culprit
사립학교	private school
비겁하다	to be cowardly
영상	picture, imagetemperature above freezing
반년	half a year
풍경	landscape, scenery
둘러보다	to look around

매번	every time, very often, always
국립	national establishment
우표	stamp
악담하다	to verbally abuse, speak ill of
석양	sunset
접속	access
인삼차	ginseng tea
둥글다	to be round, spherical

움직임	movement, motion

가루	powder, flour, dust

예습	preparation, rehearsal
익다	to ripen, be ripe, be [well] cookedto be skilled, experienced, be familiar

사이다	lemon-lime soda

숙녀	lady
자동판매기	vending machine
세일	sale

협박하다	to threaten, intimidate
단도	dagger, short sword
아나운서	announcer

도대체	(what) on earth, in the world at all
쫓아가다	to run after, pursue, keep up with

부담	burden
유치원생	kindergartener
간판	store signboard
든든하다	to be strong, secure, reassured

큰소리	loud voicebragging

난리	fuss, disturbance
파랑	blue

다지다	to chop up, minceto harden

선거	election
상상력	imagination
팽창	expansion
매달다	to hang, suspend

충돌	collision, crash, impact
음주운전	drunk driving
코끼리	elephant

해고하다	to fire, dismiss
스웨터	sweater

동대문	Dongdaemun, the East Gate
꺼지다	to be extinguished, go outto get lost, disappear (col.)

변함	change
음력	lunar calendar
잘나다	to be good, smart, distinguished

화재	fire (the kind that you call firefighters for)
중국집	Chinese restaurant
도장	stamp, sealpainting
뻔하다	to be obvious, clear

비명	scream
무사히	safely
알약	pill
잔혹하다	to be cruel, heartless, ruthless
뒷줄	back row

결코	never, by no means
위층	upstairs
유지하다	to keep up, maintain
연료	fuel
재킷	jacket

혹은	or
멋지다	to be splendid, lovely, nice

수준	level, standard
해산물	seafood, marine products
부츠	boots

영원하다	to be eternal
무술	martial arts
상당히	considerably, quite
영광	honor, glory
저렴하다	to be cheap
일등	the first classthe first place
스카프	scarf

왕복	round trip
쏟아지다	to pour, get spilt

악명	evil reputation, notoriety
강연회	lecture
권한	rights, authority
괴롭히다	to harass, annoy, trouble

무늬	design, pattern, figure

코미디	comedy

새우	shrimp, prawn

굴다	to behave, act

이모부	mother's sister's husband
쌍	pair
봉급	salary, wages
굉장하다	to be wonderful, great, marvelous
오보	false (incorrect) report
저절로	by itself, automatically

강력하다	to be strong, powerful
목사님	pastor, minister
손등	back of the hand

갇히다	to be locked (up), shut (in), confined

공유	sharing (of information, files etc.)public ownership
연보라	light purple
상점	store, shop
두드리다	to knock, tap, rapto beat, strike

경호	guard
통	totally, not at allbarrel, can, cask
미인	beautiful woman
엄청나다	to be huge, enormous, tremendous

회계	accounting
여관	inn
소극장	small theater
참조하다	to refer (to)
화염	flame, blaze
살인	murder
빠져나오다	to escape, get out

의류	clothing, clothes
볼링	bowling

짬	free time

상대하다	to deal with
더욱	increasingly, more and more

노약자석	handicapped seating
껄끄럽다	to be uncomfortable, uneasy, strained

회	time, round (count.)limeraw fish
경쟁사	competitor, rival company
노트북	notebook, laptop

해치다	to injure, harm, damage
오답	wrong answer, incorrect answer
불규칙	irregular
빨다	to wash (laundry)to suck

증거	evidence
속초	Sokcho
어지럽다	to be dizzy, feel giddyto be in disorder

선약	previous engagement
철저히	thoroughly, completely
진지하다	to be serious, earnest
유치장	jail, lockup, holding cell
자매	sisters
쌀쌀하다	to be chilly

시스템	system

천재	genius
청순하다	to be innocent, pure
수다	chatter, chit-chat

항공권	airline ticket
스치다	to graze, brush (touch lightly)

수출	export
상투적	conventional, commonplace
패스하다	to pass (an exam)

성별	sex, gender
장례식	funeral
주의하다	to pay attention, take care, be careful
극찬	high praise, compliment
이어서	continuing, following

번지다	to spread, run

업무	business, duty
승객	passenger
달려들다	to attack, jump at

온기	warmth
의식	consciousnessceremony, ritual
파혼하다	to break off one's engagement
도자기	ceramic ware, pottery
무료	free of charge (more formal)
실시하다	to implement, carry out
온종일	all day long, the whole day
규모	scale, scope
불량하다	to be poor, faulty
연세	age (hon.)
엉터리	rubbish, nonsense, fake, cheat

권유하다	to advise, suggest, recommend
동침	sleeping together, sharing a bed
초대장	(written) invitation
수리하다	to repair, fixto accept, receive
핑계	excuse, pretext

소감	thoughts (on), impression
각오하다	to be determined, be prepared
일기예보	weather forecast
조회	inquiry (into)
꼬시다	to chase (women), pick up (girls), hit on

근로자	worker, working people
망치	hammer

찌르다	to pierce, stab

국적	nationality, citizenship
샘	spring, fountainjealousy

넘어오다	to come over, cross overto fall, come down

출입	entrycoming and going
싱크대	sink
쓰다듬다	to stroke, pat

아예	from the beginningby any means

장바구니	shopping basket
미숙하다	to be inexperienced, unskilledto be unripe, immature
증세	symptom
동창회	alumni meeting, reunion
희생하다	to sacrifice
행운	good luck, good fortune
가위바위보	rock-paper-scissors
연장하다	to extend, renew
근육	muscle
이성	reason, rationalitythe opposite sex
아쉬워하다	to miss, feel the lack of

랭킹	ranking

품	bosom, breastwork, labor

억울하다	to suffer unfairness, feel victimized
안방	master bedroom
숙어	idiom
창조하다	to create
경영	(business) management, administration
현장	the actual spot, scene (of action), site
비추다	to light up, shed lightto reflect, mirror

장화	boots
머릿속	inside one's head, mind

달구다	to heat (up)

균형	balance
혁명	revolution
갖추다	to get ready, prepare

승자	winner
남몰래	secretly

받아들이다	to accept

기운	energy, vigor, strength

최신	the newest, the latest
생산하다	to produce, make
내과	internal medicine
윷놀이	yut (Korean game)

썰렁하다	to be chillyto be not funny, awkward

유산	abortioninheritance, legacy
모친	mother
존재하다	to exist, be present
연기자	actor, actress
진정하다	to be true, real, genuineto calm down
상식	common sense
고추장	red-pepper paste
건네다	to pass, hand over, deliver

하숙	boarding house
부친	father
포옹하다	to embrace, hug, cuddle
폭력	violence, force
코너	corner

찾아내다	to discover, locate, come up with

배려	consideration, regard
자발적	voluntary
건설하다	to build, construct
연극	play, theatrical performance
화제	topic, subject of conversation
두렵다	to be fearful, afraid, frightened

악몽	bad dream, nightmare
활짝	extensively, widely, fully

환하다	to be brightto be familiar (with)

대륙	continent
찜질방	Korean dry sauna, spa
딱딱하다	to be hard, stiff, firm

공주	princessGong Ju
복권	lottery (ticket)reinstatement
한턱내다	to treat to a meal or a drink

피해	damage, harm
홀로	alone, by oneself

찬란하다	to be radiant, shining, gorgeous
애교	charms, courtesy
봉사	serviceblind person
떠맡다	to take on, assume, undertake

중식	lunch (more formal)
말투	one's way of talking, style of speech
피하다	to avoid
분야	field, area (abstract)
은근히	politely, courteouslyquietly, inwardly
당황스럽다	to be embarrassed, disconcerted, confused
관리	administration, managementgovernment official
자	ruler

긁다	to scratch, scrape

직관	intuition
가정부	housekeeper
안심하다	to be relieved, rest easy
장면	scene (in a movie etc.)
기호	taste, preference (for)sign, symbol
혼내다	to scold, teach a person a lessonto scare
물결	wave

뇌물	bribe
비난하다	to criticize, attack, blame
승인	approval
한마디	a word

굶다	to starve, go hungry, skip a meal

서명	signature
건강보험증	health insurance card
곱다	to be pretty, lovely

실업	unemploymentindustry, business
곤란하다	to be difficult, toughto be embarrassing, awkward
동갑	the same age
첫인상	one's first impression
한심하다	to be pathetic, pitiful
예고	advance notice, warning
신간	new book
염색하다	to dye
용법	usage, use
시청률	(viewer) ratings
한산하다	to be quiet, empty, inactive
댓글	comment

호흡	breathing
합치다	to combine, unite, put together
주군	one's master
일거리	work, things to do, task

빌다	to ask, begto wish, prayto apologize

의외	surprise, unexpected thing
구매	purchase
조깅하다	to jog

미만	under, less than
아끼다	to spare, save, begrudge

불길하다	to be unlucky, ominous
짝	one of a set, partner

이목	attention
추천하다	to recommend
깃발	flag
최저	lowest, minimum
따스하다	to be warm

파인애플	pineapple

공동	joint, group, collaboration
감돌다	to hang (in the air)

신	shoes, footwearGodjoy, delight
또는	or

야근하다	to work (overtime) at night
승진	promotion, advancement
짝사랑	unrequited love, (secret) crush

짤리다	to be fired

시기	time, momentopportunity, chancejealousy
사방	all directions, everywhere
달콤하다	to be sweet, sugary

응급	emergency
거스름돈	change (coins)

서늘하다	to be chilly, cool

노임	wages, pay
꽉	tightly, firmlyclosely

자책하다	to blame oneself, reproach oneself
유배	banishment, exile
벌금	fine, penalty
내다보다	to look out

열정	passion
막바지	last stage, end

해명하다	to explain (oneself), clarify
손길	touch of a hand

결심	determination, resolution
켜져있다	to be lightened, be turned on

장난	game, playing (for fun)

어린애	child

진급하다	to be promoted, move up
버전	version

천연	natural
수상하다	to be suspicious, strange, shady
톤	ton (count.)tone

자택	one's own house (home)
녹다	to melt, thaw, unfreeze

탁구	table tennis
잠자리	dragonfly

원망하다	to resent, reproach, blame
투혼	fighting spirit
놀이터	playground

지지하다	to support, back up
회계사	accountant
외모	appearance
소박하다	to be simple (and honest)
삼각	triangle
킬로그램	kilogram

껴안다	to hug, embrace

환상	illusion, fantasy
교도소	jail, prison
다정하다	to be affectionate, friendly, intimate
풍습	customs, manners
넋	soul, spirit

흔하다	to be common, commonplace

노릇	role, function

종반	the last phase (stage)
물러서다	to step back, back off

연구소	research institute
설정	setup, setting
소생하다	to revive, recover
항공	aviation, flight
조언	advice
체포하다	to arrest
분수	fountainfraction
재주	talent, skill
비참하다	to be miserable, wretched, tragic
몰다	to drive, steer

반전	reversal, turnaroundantiwar
버티다	to endure, last, hold out

전설	legend
호감	good feeling, favorable impression
붙잡다	to catch, hold, grasp

생시	reality
그럭저럭	somehow

입력하다	to enter, input
주방	kitchen (2)
동창	fellow students, classmates
더듬다	to grope, feel around

적절하다	to be appropriate, adequate, proper
의도	intention, aim, purpose
제과점	bakery
투표하다	to vote
되찾다	to recover, regain

침	saliva, spit

운명	fate, destiny
쓸모있다	to be useful

싱가포르	Singapore

내기	bet, betting

상속하다	to inherit
얼어붙다	to be frozen

내부	the inside, inner part
생물	living thing, creature
다그치다	to push, press (with words, not physically)

수레	wagon, cart

뒷담화	talking behind someone's back
실망시키다	to disappoint
꽂다	to put into, stick into

귀신	ghost, spirit
육개장	spicy beef soup
지독하다	to be viciousto be awful, terrible, severe
축제	festival
소원	wish, desire
요란하다	to be noisy, be loud
의리	loyalty
도리어	on the contrary, instead

밀치다	to push, shove

변명	excuse, justification
와이셔츠	dress shirt

목격하다	to witness, observe
와인	wine

불국사	Bul Guk temple
동거하다	to live together
참고	reference
외부	the outside, the exterior
재우다	to put [send] someone to sleep [bed]

딛다	to step (on)

금융	finance
신제품	new product
심사하다	to screen, evaluate, judge
찬성	agreement, consent, approval
터미널	terminal

사소하다	to be trivial, insignificant
두려워하다	to be afraid, scared of

볶음밥	fried rice

참치	tuna
시달리다	to suffer (from)

수신	reception
제국	empire
촌스럽다	to be rustic, tacky, out-of-style
바람둥이	womanizer, playboy

연하	younger, junior
애쓰다	to make efforts, go to trouble

늦잠	sleeping late (in the morning), oversleeping

재판	trialsecond edition
야릇하다	to be strange, funny, peculiar

남김없이	entirely, without exception

화가	painter, artist
부리다	to manage, handleto raise, create, show, have

화해하다	to be reconciled, make up with
잔디	grass, lawn

올림픽	Olympic

영리하다	to be smart, clever, bright
바탕	foundation, basis

녹음실	recording studio
확정하다	to determine, decide, settle, fix
노래자랑	singing contest

소화	digestion
겸손하다	to be modest, humble
산보하다	to walk, stroll
미혼	single, unmarried
침묵	silence
깔끔하다	to be neat, tidy

스타킹	stockings

하필	why of all the [things, people etc.]
노출하다	to expose
본체만체하다	to ignore, pretend not to see

환불	refund
차표	ticket for train/bus
존중하다	to appreciate, respect
보상	compensationreward
진단	diagnosis
우습다	to be funny, amusing

지문	fingerprint
이만	just this much, this far, to this extent

조절하다	to control, adjust, regulate
파마하다	to get a perm

신분	social position
교복	school uniform
빠뜨리다	to drop, throw intoto omit, excludeto tempt

호응	(positive) response
차별	discrimination
미루다	to delay, postpone

하얀색	white

진주	pearl
망하다	to go to ruin, go bankrupt, perish
엉망	wreck, mess, bad shape

계급	(social) class
감싸다	to cover, wrap (up), shelter

검찰	the prosecution
교무실	teachers' room
살아가다	to lead a life, get along, keep living

집착	obsession
스키장	ski resort
희미하다	to be dim, faint, vague
빈자리	empty seat, vacant spot

부주의	carelessness
맞이하다	to welcome, greet, receive

거치다	to go through, pass (through)

만원	full house (no space for more people)
인류	humanity, mankind
나아가다	to advance, proceed

콤비	combination

뼈	bone

넘어뜨리다	to throw down, tip down, push down

위선	hypocrisy
취침	going to bed, retiring
쐬다	to get (fresh air), be exposed (to sun)

귀띔	hint, tip

주식	stocks, sharesprincipal item of diet
나뉘다	to be divided, be apart

텐트	tent

애들	kids (short from 아이들)

욕먹다	to be blamed, be criticized, be reproached
지켜보다	to watch, observe
호적	family register
남매	brother and sister
면도하다	to shave
제약	restriction, limitationmanufacture of medicines
우정	friendship
부당하다	to be unfair, unjust
강도	strength, intensityrobber, robbery
필수	essential, required
부적절하다	to be inappropriate
까다	to peelto hatch

체육관	gym
권투	boxing
설레다	to flutter, vibrate

해안	coast, seaside
다름없이	equally, similarly, in the same way

통과하다	to pass, get through
번쩍	in a flash, in a breath

시상식	awards ceremony
성취하다	to achieve, accomplish
홀랑	naked, nude

안개	fog, mist

통역하다	to interpret (translate orally)
위협	threat, intimidation
양다리	double-deal, both ways (also used in the context of cheating)
구분하다	to divide, classify
비만	fatness, corpulence
인내심	patience, endurance
돌보다	to look after, take care of

건드리다	to touch, meddle with, provoke

헬스클럽	health club, gym

부대	unit, troopsbag, sack
울적하다	to be depressed, gloomy, cheerless
논리적	logical
일체	all, the wholeentirely, absolutely
빼앗다	to take away, robto fascinate, captivate

과로	working too much, excessive labor
명예	honor, distinction, fame
속삭이다	to whisper

상징	symbol
언덕	hill slope

지시하다	to direct, instruct
외삼촌	maternal uncle
숙소	lodging, accomodations
추측하다	to guess, suppose
취득하다	to acquire, obtain
초인종	doorbell
대낮	the middle of the day

갚다	to pay back, repay

살살	gently, softly

베개	pillow

야단치다	to scold, rebuke
각설하다	to change the subject
상사	one's boss, superior
예의	(good) manners, courtesy
의논하다	to discuss (with), consult
채널	channel

벌떡	suddenly, abruptly

찢다	to tear, rip

클래식	classic

당번	duty
멀어지다	to grow apart, drift apart

언제든지	anytime

순번	turn, go
감당하다	to be able to fulfill the dutiesto handle, manage, deal (with)
마사지	massage

이민	emigrationimmigration
닥치다	to approach, draw nearto shut up

의문	question, doubt
빈대떡	green-bean pancake

접다	to fold
조끼	vest

영양	nutrition, nourishment
참여하다	to participate (in)
슬리퍼	slipper

졸업식	graduation ceremony
가물가물하다	to be blurry, blurred

물냉면	cold noodles served in water
전통적	traditional, conventional
부러지다	to be broken, snap

지도하다	to guide, direct, coach
형식	form, formality
인상적	impressive
중요시하다	to put a high value (on), regard as important
탕수육	sweet and sour pork
재즈	jazz

뜨다	to floatto riseto open (eyes)

카레	curry

본업	main occupation
정해지다	to be set, arranged, determined
백수	being out of work, unemployedall kinds of animals
현실적	realistic, practical
닳다	to wear out

짬뽕	Chinese spicy noodle soup

안동	Andong
빨개지다	to turn red

묵다	to stay (over night)to get old

자가용	one's own car
울음	crying
양보하다	to yield, give, concede
채	counter for houses

현상	the present situation, existing circumstances
띄다	to leave a spaceto be visible, stand out
왕관	crown
되돌리다	to restore, put back, return

탈	mask, disguisesickness
우연	coincidence, chance
명랑하다	to be cheerful, bright
출퇴근하다	to commute
멀미	nausea, motion sickness

홈페이지	website, home page

책임지다	to take responsibility
또한	also, too, as well

사적	private, personal
싱싱하다	to be fresh

저울	scales, balance

자존심	self-respect, pride
떠오르다	to come across one's mindto rise up

동해	the East Sea
실	thread, yarn

정차하다	to stop, make a stop (about vehicles)
전시회	exhibition, display
세배	New Year's bow
겪다	to undergo, suffer

설사	diarrhea
작업	work, operation
귀여워하다	to treat affectionately

걸치다	to extend, stretchto wear, throw on

남해	the South Sea
샴페인	champagne

출판하다	to publish
행위	act, action
장관	ministermagnificent sight, grandeur
삐다	to sprain, twist

언급	mention, reference
계집아이	girl

태워주다	to give a person a ride

눈사람	snowman

고소	accusation, (legal) chargewry smile
빚지다	to get into debt

도전	challenge
마라톤	marathon

수집하다	to collect, gather
뜬금없이	all of a sudden

인심	one's mind, one's heart
베다	to cut, slash, sawto rest one's head on

제복	uniform
대한민국	Republic of Korea
뛰어가다	to run, dash

형수	one's elder brother's wife
서방	husbandthe West
해당하다	to be relevant, to correspond (to)
놀이공원	amusement park
상대	business schoolcounterpart
올리다	to raise, lift upto offer

회비	membership fee
핸드백	handbag

존경하다	to respect, look up to
매운탕	spicy fish stew
사위	son-in-law

벌이다	to start, set up, stage

중독	poisoningaddiction
기념품	souvenir
삭제하다	to delete, remove
부정	denial, negationcorruption, dishonestyunfaithfulness
사내아이	boy

절박하다	to be urgent, desperate
실제	truth, reality
예고편	preview, trailer
감독하다	to supervise, oversee
화면	screen, picture
굽	heel

빌려주다	to lend, loan
거지	beggar

외계인	alien
격려하다	to encourage
물고기	fish

생신	birthday (hon.)
기죽다	to be discouraged

동작	movement, action
개구리	frog

돋보이다	to stand out, show to advantage

야망	ambition, aspiration
뽀뽀	kiss, peck

구박하다	to ill-treat, mistreat
소비	consumption
정략	political scheme, move
돌아가시다	to pass away, die (hon.)
우승	victory, championship
돌멩이	stone, pebble

쫓아오다	to follow, chase

관점	point of view
온수	warm water
괘씸하다	to be disgraceful, outrageousto be disgusted (with, that)

실체	truth, true nature
주민등록증	ID card
엄연하다	to be undeniable, clear
구성	composition, organization, formation
시상	awardpoetic concept, idea
보류하다	to postpone, put off
너무나	too much

안색	complexionthe look on one's face
저장하다	to store, preserve
도로변	roadside
전하	Your Highness
속다	to be deceived, be fooled

장군	general, admiral
낯	face

잠그다	to lock

필통	pencil case
고아	orphan
가입하다	to join, subscribe
대충	roughly, approximatelyalmost, practically

임무	duty, task
상쾌하다	to be refreshing, fresh
밑줄	underline

순위	rating, ranking, position
들려오다	to reach one's ears

폭풍	storm, windstorm
동그라미	circle

달라고 하다	to request (ask) to give

입맛	appetite, taste

방안	plan, way
비꼬다	to be sarcastic

철도	railway
상영	screening, showing (a movie etc.)
엿듣다	to eavesdrop, overhear

군중	crowd
줄거리	outline, synopsis, plotstalk, stem

치사하다	to be shameful, disgraceful, cheating, meanto thank someone, express gratitude
대개	mostly, generally
차이점	differences, points of distinction
갈다	to change, replaceto sharpen, grind, hone

물약	liquid medicine
정열	passion, enthusiasm
연구실	(professor's) officelaboratory
지겹다	to be tedious, boring, dull

직후	immediately after
된장찌개	soy bean paste stew
야경	night view
박히다	to be stuck (in), embedded

태극기	national flag of Korea
학비	school expenses, tuition fees
기세	spirit, force
소독하다	to disinfect, sterilize
레몬	lemon

부하	subordinate
목숨	life

겁쟁이	coward
연주하다	to play (a musical instrument), to perform
부침개	vegetable pancake

오직	only, solely

늑대	wolf

외치다	to cry out, shout, yell

터널	tunnel

위기	crisis
국제적	international
찌푸리다	to frown, scowlto cloud over

자살	suicide
헤어스타일	hairstyle

기내식	in-flight meal
찌다	to gain weightto be steaming hot, be sultryto cook with steam

밤새	all night

적립	saving, accumulation
노름하다	to gamble

유언	will, testament, dying wish
사다리	ladder

반사하다	to reflect
수갑	handcuffs
가해자	attacker, perpetrator
불리하다	to be unfavorable, disadvantageous
부채	fan, folding fandebt, liabilities
흉기	deadly weapon
쓸데없다	to be useless

빚	debt, loan

대기실	waiting room
특이하다	to be unusual, peculiar, unique
자정	midnight
불평	complaint
까다롭다	to be particular (about), fussy, difficult

꼬마	(little) kid

느닷없이	suddenly, abruptly

데우다	to heat (up), warm (up)

억지로	against one's will, by force

결석	absence
예방하다	to prevent
워낙	very, by nature

경복궁	Gyeong Bok palace
여쭤보다	to ask (hum.)

설렁탕	beef and noodle soup
진가	true value, real worth
증명하다	to prove, demonstrate, confirm
사흘	three days

회견	interview
기대다	to lean (on), rest (against)

어찌	how, what

상담	advice, consultationbusiness talk
확보하다	to secure, ensure, assure
충고	advice
연예인	entertainer, celebrity
무리하다	to exert energy, overstrain (oneself)
대만	Taiwan
북한	North Korea
처리하다	to handle, deal with, take care of
미처	as far as, to that extent

최악	the worst
눌리다	to be squeezed, be pressedto be oppressed

내복	long underwear
비타민	vitamin

꼬다	to twist, cross, entwine

수수께끼	puzzle, riddle

귀하	sir, madam
복용하다	to take (a dose of) medicine or drugs
미장원	beauty parlor, hair salon
소스	sauce

투자하다	to invest
제비	playerlotswallow

목적지	one's destination
반납하다	to return, give back, hand in
눈싸움	snowball fightstaring contest

영구히	eternally, permanently
제출하다	to submit, hand in, present
가구점	furniture store
반도	peninsula
진열하다	to display, exhibit
관계자	the interested parties, affected persons
효자	filial (devoted) son
암기하다	to memorize
거꾸로	upside down, inside out, backwards

지극히	very, extremely, perfectly
하이힐	high-heeled dress shoes

태연하다	to be calm, composed, nonchalant
총장	chancellor, secretary general
구조	structure, organizationrescue
단층집	single-story house
새하얗다	to be pure white, snow-white

사표	(written) resignation
수익	profit, earnings, revenue
기본적	basic
마주치다	to meet with, come across

차고	garage
무선	wireless, radio
보트	boat

횡설수설하다	to talk nonsense, babble, speak incoherently
첫눈	the first sightthe first snow (of the season)

대사	lines, dialogueambassador
창밖	outside the window
포근하다	to be warm, mildto be soft, comfortable

동전	(copper) coin
여배우	actress
소매	sleeveretail
바래다	to fade, lose color

예감	premonition, foreboding, hunch
전차	tramtank
시간표	schedule, timetable
들려주다	to let hear (i.e. tell, read to, inform etc.)

모범	example, (role) model
약점	weakness, weak point
끌어내다	to take out, bring out, drag out

간첩	spy, secret agent
교외	the suburbs
흥분하다	to be excited, be stimulated
횟수	number (of times)
권총	pistol, gun
뚜렷하다	to be distinctive, clear

안과	ophthalmic hospital
이발소	barber shop
결백하다	to be innocent
멜론	melon

기술자	technician, engineer
유효하다	to be valid
작곡	composition (of music)
강의	lecture
재촉하다	to hurry, rush, push

판소리	traditional Korean singing drama

장부	ledger, books, account
가만두다	to tolerate, leave as is

축복	blessing
농부	farmer, peasant
꼼꼼하다	to be careful, meticulous

팩스	fax

죄책감	feeling of guilt, guilty conscience
내가다	to take out, take away, remove

공해	pollution
최소	the smallest, minimum
도망치다	to run away, escape
제작	production, making
성향	tendency, inclination
경솔하다	to be careless, rash
발매	sale
방면	directionway, aspect
미련하다	to be stupid, foolish

성당	Catholic church
제자리	the proper place, the original place

훔치다	to steal, swipe, liftto wipe, mop

파스	pain relief patch

퇴장	walkout, exit, departure
맴돌다	to circle, hover

독	poisonjar
마술	magic
황당하다	to be ridiculous, absurd, nonsensical
성적	grade, mark
인연	tie, connectiondestiny
순하다	to be gentle, mild, meek
이기적	selfish
결론	conclusion
못되다	to be bad, mean, evilto be under, short of

조치	action, steps, measures
절반	half
거스르다	to go upstreamto give change

두부	tofu
급속히	rapidly
끔찍하다	to be terrible, horrible

공격	attack, assault
악수	handshake
평범하다	to be ordinary, common
사투리	dialect

괴물	monster
도둑질하다	to steal, rob

처녀	unmarried (single) woman, maiden, virgin
기웃기웃	peeping, snooping

애원하다	to beg, plead, entreat
수수료	commission, fee
관사	article (grammatical)official residence
공개하다	to make public
억양	intonation, accent
표준	standard, norm, average
여리다	to be tender, soft, delicate

게	crab

급료	salary
엎다	to turn upside down

할리우드	Hollywood

교대	rotation, shift, alternation
증가하다	to increase, grow
은행원	teller, bank clerk
답변	answer, reply
짙다	to be dark, deep, thick

털	hair, fur, feather

취향	taste, liking, preference
유혹하다	to tempt, lure, seduce
잠바	jacket

오누이	brother and sister

가르다	to divide, cut, split

어르신	senior citizen, elderly

메달	medal

따다	to pick, pluckto obtain

쓸쓸하다	to be lonely, forlorn

환상적	fantastic
반팔	short-sleeve shirts
유치하다	to be childish, immature
엑스레이	X-ray

매체	media
거듭나다	to reform, turn over a new leaf

매연	exhaust (fumes)
을지로	Euljiro

육박하다	to approach, draw near, close in
세트	a set

재수	luck, fortune
달래다	to soothe, calm (down)

태풍	typhoon
장사	business, trade

감격하다	to be deeply moved
단골	regular customer

우체부	mailman
밀리다	to be delayed, be behind, be overdue

몽땅	all

면허증	license, permission
불행하다	to be unhappy, unfortunate
레이더	radar

과연	indeed, sure enough
틀다	to twist, turnto switch on

습도	humidity
사치품	luxury goods
지저분하다	to be messy, disordered, untidy

대체로	generally, mostly
흑인	black, ethnic African
무덥다	to be stifling, humid, sultry

명물	specialty
현대인	modern people
고독하다	to be lonely, solitary
떡볶이	rice-stick with vegetables

내내	throughout, all the time, from start to finish

비롯하다	to include

억	hundred million
일식집	Japanese restaurant
눅눅하다	to be damp, humid

사인	signature, autographcause of death
장마철	the rainy season

불쾌하다	to be unpleasant, uncomfortable
사납다	to be wild, fierce, violent

전해주다	to deliver, convey, report
초밥	sushi
횡재	windfall
흥정하다	to bargain, haggle over terms

다투다	to fight, argue, struggle

신청곡	song request
세대	generation
선명하다	to be clear, distinct, sharp
청취자	listener (of a radio or similar)
애절하다	to be sad, touching, pathetic
카세트	cassette

세차하다	to wash a car
품질	quality
종로	Jongno
거절하다	to refuse, decline, reject
실시간	real time, live
무모하다	to be rash, reckless
부유하다	to be rich, wealthy
마룻바닥	the floor

목록	list, catalogue
공평하다	to be fair, just, even-handed
생물학	biology
건조하다	to be dry
책임자	person in charge
별장	vacation home, cottage
넘어서다	to pass over, exceed

서너	three or four

야간	night, night time
유용하다	to be useful, helpful
자주색	purple, violet
분류하다	to classify, categorize
탈의실	dressing room
불결하다	to be dirty, unsanitary, filthy
따끈따끈하다	to be hot, warm

신비하다	to be mysterious
통조림	canned food
매	hawk, falconwhip, rod

귀중하다	to be precious, valuable
은은하다	to be vague, faint
향기	scent, fragrance
수정과	dried persimmon punch
기린	giraffe
중앙	center, middle
생활비	living expenses, the cost of living
불꽃	spark, flame

국제선	international flight
삶다	to boil, cook

평가	appraisal, evaluation, assessment
맏아들	the eldest son

우애	brotherly love
내적	inner, internal
자랑거리	something one is proud of

자동	automatic
돌아다니다	to wander around, roam

양심	conscience
유괴하다	to kidnap, abduct
유머	humor

피서	summer retreat (out of town), summer vacation, getaway
파일	file

시력	eyesight
도서	books, publications
국경	border, boundary
탑	tower, pagoda
재혼하다	to remarry, marry again
바둑	Go (the board game)

온천	hot spring
부수	number of copiesradical
공상과학	science fiction
항의	protest, complaint
일상	everyday, daily life
수십	tens, scores, dozens
칠순	the age of seventy
영토	territory, domain
물질	matter, substance, material
외할머니	maternal grandmother
처방	prescription
월세	monthly rent
어귀	entrance

항구	port, harbor
장녀	eldest daughter
하반기	the second half of the year
폭발하다	to explode, blow up, detonate, erupt
첩	concubine
얌전하다	to be gentle, well-behaved, obedient, modest

따님	daughter (hon.)
솜씨	skill, ability

단풍	tinged autumn leaves
시동	starting (of a machine)
짝퉁	fake, imitation

충전하다	to electrify, charge
등신	fool, idiot
중지하다	to discontinue, stop, suspend
부디	please

유료	requiring payment
장인	one's wife's fathermaster craftsman
육감	sixth sense, gut feeling
부서지다	to break, break down, become out of order

신형	new model, new style
과장하다	to exaggerate
문맥	context
전주	last weekJeonju
안약	eye drops
관람	viewing, inspection
귀찮다	to be troublesome, bothersome, annoying

메다	to carry on one's shoulderto choke (up)

고려하다	to consider, take into account
상품권	gift certificate
여의도	Yeouido
평균	average, mean
분량	quantity
고요하다	to be still, quiet, calm, silent, peaceful

말끔	all, completely, thoroughly

고용하다	to hire, employ
초급	elementary (beginning) level
째려보다	to look unkindly at
둔하다	to be dull, slow, stupid
이데올로기	ideology

간접화법	indirect speech
이래	since
백성	the people, the public
청년	young man, young people
돌이키다	to look back on, reflectto undo

용의자	suspect
데모	demonstration

식모	maid, domestic help
들러리	best man, bridesmaid

업체	business, enterprise, concern
펴놓다	to spread, lay out, keep open

파악하다	to grasp, understand, figure out
실천	practice, action (as opposed to just talking)
나르다	to carry, transport

이윽고	eventually, at last, finally

한눈	one eyea look, a glance

눈부시다	to be dazzling, glaring, brilliant

빈틈	gap, crack

방패	shield
입찰	bid, tender
작성하다	to draw up, write out, prepare
압구정	Apgujeong
건장하다	to be well built, have a strong physique
혈압	blood pressure
용납하다	to allow, permit, tolerate
험하다	to be rugged, rough, sinister
물러나다	to fall back, retreat, retire

무례하다	to be rude, disrespectful
색칠하다	to color, paint
최고급	highest grade, top class
종료	end, conclusion, termination
위엄	dignity
훈훈하다	to be comfortably warm
엔지니어	engineer

빤히	evidently, obviouslyintently

선	linegoodness, virtuemeeting with a prospective marriage partner
무렵	time

뺨맞다	to get slapped

얼룩	stain, spot

편견	prejudice, bias
지지난	the day, week, month, etc. <b>before last</b>

분실	loss
전편	the whole book (movie, series etc.)the original book (movie)
급식	food service
설화	tale, story
모음	vowel
예비군	reservist, reserve forces
부정확	inaccuracy, incorrectness
작전	operation, military action
새집	new housebird's nest

착각하다	to be under an illusion, delude oneself
드러내다	to reveal, expose, show

유력하다	to be influential, leading, powerful
음성	voicenegative
잠실	Jamsil

올바르다	to be straight, upright, correct

위대하다	to be great, grand
지혜	wisdom, wit
독특하다	to be peculiar, unique, distinctive
처지	position, circumstances, situation
조미료	seasoning, condiment
식용유	cooking oil
해바라기	sunflower

깨	sesame

물끄러미	with a blank look

금품	money and valuables
몸매	one's figure

듬직하다	to be reliable, dependable

활발하다	to be lively, active
자상하다	to be attentive, considerate, thoughtful
지적하다	to point out, indicate
신청서	application form
온전하다	to be whole, intact
음절	syllable
앞면	the front
북녘	north
펭귄	penguin

해변	beach, seashore
관광객	tourist
요원	agent
장물	stolen goods
순진하다	to be naive
쏘다	to shoot, fire

앙큼하다	to be sly, cunning

연락선	ferry
신속하다	to be quick, prompt, swift
마지못해	reluctantly, grudgingly

숙면	deep sleep, sound sleep
얼빠지다	to be dazed, be dull-headed, lose one's senses

악성	bad, vicious, malignant
포장마차	(covered) cart bar, snack stall
바래다주다	see a person home

현관	front door, entrance, foyer
말대꾸하다	to talk back, retort

꼬박꼬박	regularly

잔뜩	to the greatest possible extent, to the fullest

시리다	to be cold (about one's body parts)

택배	parcel delivery service
꿇다	to kneel (down)

인턴	intern

엽서	postcard
극복하다	to overcome
실연하다	to be disappointed in love, heartbrokento demonstrate
배신하다	to betray
명상	meditation
영업시간	business hours
사직서	letter of resignation
힘내다	to gather heart, cheer up

전처	one's former wife, ex-wife
야무지다	to be sturdy, skillful, shrewd

출연하다	to appear (in a movie etc.)
원기	energy, vigor
밥상	dinner table
씩씩하다	to be brave, manly

탈락하다	to drop out, be eliminated
쓰레기통	garbage can, waste basket
오븐	oven

장식장	display cupboard, cabinet
주전자	kettle
화장대	dressing table
소방관	fireman
일과표	daily schedule
투명하다	to be transparent
유행가	popular song
직전	just before
일출	sunrise
구역	area, zone, district
삽	shovel

대장	general, admiralleader, commander
팔씨름하다	to arm wrestle

뺏다	to take (away), snatch

야단맞다	to be scolded thoroughly
고자질하다	to tattle, tell on
강의실	lecture room
시시하다	to be dull, boringto be trivial, insignificant

새치기하다	to jump the queue, cut in line

가버리다	to be gone

솥	iron pot

피해자	victim
올바로	honestly, uprightly, properly

화창하다	to be sunny
통통하다	to be plump, chubby

머물다	to stay, remain

터지다	to burst, blow up, explode

추가하다	to add, supplement
허리띠	belt

정오	noon, midday
고아원	orphanage
다락	attic

안부	regards
화랑	art gallery
싸늘하다	to be cool, chilly

어리석다	to be foolish, stupid, silly

뾰족하다	to be pointed, sharp

외딴	isolated, remote

탄탄하다	to be solid, strong, robust

뒤돌아보다	to look back

친숙하다	to be familiar
그리움	longing, yearning

또래	peer (group), same age group

뒤쳐지다	to be left behind

표준어	standard language
탈출하다	to escape
함정	trap
불타다	to burn, be in flames

업다	to carry on one's back

파업	strike, walkout
썩다	to rot, decay, go bad

통제	control
하찮다	to be trivial, petty, insignificant

사진기	camera
앞지르다	to pass, overtake, get ahead

정열적	passionate
회화	conversationpainting
재다	to measure, gauge

이별하다	to part, separate
도저히	not at all, no way
포위하다	to surround, encircle
명심하다	to keep in mind, remember
고무	rubber

문방구	stationerystationery store
사기꾼	con artist, swindler
급여	pay, salary
논	rice field

동점	tie, same score
정형외과	orthopedics
꼴불견	unsightliness
봉사활동	community service activities
옛일	things of the past

교과목	subject, course
충전기	charger
청구서	bill, invoice
계산원	cashier
재채기하다	to sneeze

교양	sophistication, refinement
말짱하다	to be impeccable, neatto be perfectly okay
응답	answer, response
차이다	to get kickedto be dumped
재계	the financial world, business circles
집단	group
소심하다	to be timid, shy
김새다	to lose intereset, enthusiasm, be disappointedto spoil one's fun

감추다	to hide, conceal

원칙	principle, general rule
양초	candle
처자	one's wife and childrena maiden
공지하다	to announce, notify
얕다	to be shallow

다람쥐	squirrel

수줍다	to be shy

진실되다	to be true, truthful, sincere, real
맹세하다	to swear, pledge
파트너	partner

확대하다	to expand, magnify
배송	shipping, delivery
영화제	film festival
높임말	honorific language (style, words)

신입사원	newly hired employee
옆집	next door

연주회	concert, recital
벽보	poster
고사하다	to reject, declineto wither (away)
합창단	choir, chorus
후보	candidate, nominee
앞서	before, earlier

숙이다	to drop, lower, bow, bend

되뇌다	to repeat, say (many times over)

고집	stubbornness, insistence
잠수하다	to dive, go underwater
널리	widely, broadly, all over

이롭다	to be beneficial, do good

먹이	food, feed

녹음기	recorder
전시하다	to exhibit, display
가곡	song
들키다	to get caught, be discovered

상견례	meeting (between the families of the bride and the groom)
교훈	lesson, moral
양쪽	both sides
실컷	to one's satisfaction, as much as one likes

연수	training, study
알몸	naked body

해수	seawater
두통	headache
애완동물	pet
아웃	out

신중하다	to be cautious, prudent, discreet
팔꿈치	elbow

단위	unit, measure
모집하다	to recruit, invite
등장하다	to appear, make an appearance
한계	limit, boundary
솜	cotton

선전	propaganda,advertisement
세균	bacteria, germ
연속	series, streak, continuation
연인	sweetheart, lover
화장지	toilet paper
저항	resistance, defiance
손해	damage, loss
급히	hastily, in a hurry
문패	doorplate
혼동하다	to confuse, mix up
번갈아	alternately, by turns
난로	heater, stove
파괴하다	to destroy, ruin
임시	temporary
갈등	conflict
초기	the early days, the beginning
이론	theory
골탕먹다	to suffer a big loss, be cheated
사기	fraud, deception, scammorale, fighting spirit
탓	reason, blame

끝장	end, conclusion, termination

회복하다	to recover, regain, get better
녹화	video recording
기자회견	press conference
무지	ignorance, stupidityvery, extremely
군소리	unnecessary remark

이어폰	earphones

웬만하다	to be tolerable, fairly good

잽싸다	to be quick, swift, agile

이륙하다	to take off (about planes)
뛰어나다	to be outstanding, excellent

한반도	the Korean peninsula
풍부하다	to be plentiful, ample
인근	vicinity, nearby
어긋나다	to be contrary, at cross purposesto go amiss

맺다	to bear, produceto form

방울	drop (of liquid)bell

흘러내리다	to run down, trickle down

모질다	to be harsh, hard, severe

밋밋하다	to be flat, plain, dull

그저	without any reason

절망	despair, hopelessness
이성적	rational, reasonable
먼지	dust

멋대로	as one pleases, selfishly

주의사항	matters that require (special) attention
질색하다	to detest, loathe
양치질하다	to brush teeth
반응	response, reaction
건배	toast, cheers
원수	enemy
스타일	style

데뷔하다	to make one's debut

출렁거리다	to slop, splash, roll

재난	disaster, catastrophe
암	cancer
스킨십	touch (skin to skin, with affection)

박다	to thrust in, hammer, drive

크레파스	crayon

켤레	a pair

학과	(university) department, majorlesson, classwork
언론	the press, the media
암소	cow

주정하다	to act in a drunken and disorderly way
껍데기	shell, skin

녀석	guy, fellow

미끈미끈하다	to be all slippery, very smooth

맨손	bare hands

부딪치다	to bump against, crash into, collide

기절하다	to faint, pass out
결승	finals
혈액	blood
성형수술	plastic surgery
관습	custom, convention
근시	nearsightedness
교정하다	to proofreadto correct
조명하다	to illuminate, highlight
오싹하다	to shudder, feel a chill

원점	starting point
휴식	rest, relaxation
유리하다	to be favorable, advantageous
법칙	law, rule
육지	land
신하	servant, vassal, government officer
감염	infection
정지하다	to stop, halt
수명	life, life span
밤새우다	to stay up all night

엘리베이터	elevator

난방	heating
불어	French language
망치다	to spoil, ruin, screw up
아담하다	to be neat, tidyto be petite
외향적	extroverted, outgoing
탐내다	to want, desire, covet
어기다	to break, violate

의젓하다	to be mature, dignified

진학하다	to enter (a higher level of) school
낭만	romance
사연	story, situation
예정일	due date
착수하다	to start, launch
단조롭다	to be monotonous
이력	background, personal history, record
이주하다	to move, migrate
애매하다	to be vague, obscure, uncertainto be wrongly accused
특집	special edition
사막	desert
출신	native, origin
동영상	video
냉정하다	to be cool-headed, objective, cold-hearted
관광지	tourist attraction [spot]
이끌다	to lead, guide

콘센트	socket, electrical outlet

여기다	to regard, consider

굴뚝	chimney

평평하다	to be flat, even
따갑다	to be stinging, burning, irritated (for one's skin or body parts)

놓아두다	to leave (as is)

정화	purification
뱉다	to spit out

천벌	divine punishment
정밀	detailed, precise, exact
구석구석	every nook and corner

멎다	to stop

문화재	cultural assets
여신	goddess
엉덩이	butt, buttocks

종영	end (of a show or movie)
합의	agreement, consentconsultation
피신하다	to escape, flee, take shelter
청춘	youth
건국	establishment of a country
금실	marital chemistry (harmony)
어림	rough estimate

지휘하다	to command, lead, direct
죄목	charge, name of a crime
자재	materials
인하	reduction, cut
경청하다	to listen attentively
용감하다	to be brave, daring, courageous
등불	lamp, lamplight
백과사전	encyclopedia
대상	object, targetgrand prize
음반	record, album
견적	estimate (for)
기막히다	to be struck dumb, be stunnedto be perfect, fantastic
물품	item, articlegoods
동참하다	to join, take part in
화살표	arrow
설득하다	to persuade
퇴직	retirement
대우하다	to treat
접수	receipt, reception
도심지	downtown
실종	disappearance
예능	artistic talents
단둘	two persons (alone, in private)

외양	appearance, look
피로	fatigue
수거하다	to collect, pick up
첨부하다	to attach
간주하다	to regard, consider
저주	curse (magical)
발행	publication, issue
안락하다	to be comfortable
숟갈	spoonful (of sugar or other ingredients)

주동자	leader
충성	loyalty, devotion
엎드리다	to lie face down

뻗다	to reach, stretch out, spread

토박이	natives
오냐오냐하다	to overindulge, allow [kids] everything

사양	specificationrejection, declining
소장	manager, headwritten complaint, petition
수속	procedure
생생하다	to be vivid
당사자	the person directly involved
면전	to one's face
주저하다	to hesitate
기약	promise
납득하다	to accept
주선하다	to arrange, set up
뚫다	to bore, dig, pierce

독신	bachelorhood
최대한	maximum, at the most
미화하다	to glorify, glamorize, romanticize
주름	wrinkle, crease

건축	architecture, construction
뒤지다	to look through, go through, search for, rummage<br />to fall behind

미모	good looks, beautiful face
겸비하다	to have both, combine
웅변	eloquence, oratory
어림없다	to be far from, be beyond

납기일	pay day, date for payment
울보	crybaby

낭비하다	to waste
기어이	no matter what, without fail
거칠다	to be rough, coarse

쟁반	tray
체조	gymnastics
무덤	grave, tomb

동호회	club, society
풍선	balloon
줄곧	all the time, continually

연말	end of the year
유부남	married man
솟다	to riseto gush out, flow out

헌	old, shabby, used

간섭하다	to interfere, meddle
가보다	to have been to a place

맞히다	to hit the mark, guess right

체험	experience
데다	to be burnt, get scorched, scald oneself

원한	grudge
넉넉하다	to be sufficient, plenty

초조하다	to be anxious, restless, impatient
공감	sympathy
적중하다	to hit the mark (target), come true
재방송	rerun, repeat
영웅	hero, heroine
멀뚱멀뚱	blankly, vacantly

건축물	building, structure
거문고	Korean harp

굴	caveoyster
소매치기	pickpocket

과식하다	to overeat
복장	attire, clothes
체결하다	to conclude (a contract), to sign
빈방	vacant room
은혜	favor, kindness, benefits
큰아버지	father's elder brother

큰어머니	father's elder brother's wife

운동복	sportswear
국어	national languagemother tongue
외할아버지	maternal grandfather
남미	South America
소설가	novelist
끊어지다	to break down, break off, snap, run out

기뻐하다	to be pleased, happy, glad

수돗물	tap water
업소	business establishment
합창	chorus, ensemble
완강하다	to be stubborn, insistent
줄다	to decrease, shrink, lose size

마약	drugs, narcotics
전화비	telephone bill
멕시코	Mexico

경기장	sports stadium
서먹하다	to feel awkward, be ill at ease

시외	the suburbs, outside the city limits
배탈	upset stomach, stomachache
영하	temperature below freezing
학생증	student ID
사원	employee, member of the staff
점퍼	jacket, windbreaker

조그마하다	to be small, tiny

소형	small item, small size
면세점	duty-free shop
쿨	cool

아랍	Arab

로션	lotion

즐거움	pleasure, joy, happiness

봉지	bag, sack
깃	collarfeather

베트남	Vietnam

벚꽃	cherry blossoms

담그다	to soak, immerse

당당하다	to be imposing, commanding
추리소설	mystery novel
경력	career, work experience
무궁화	Rose of Sharon
나흘	four days

떡국	rice-cake soup

후원	support, backing, sponsorship
반성	self-reflection, self-examination
가두다	to shut in, lock up

남대문	the South Gate
브라질	Brazil

외숙모	maternal uncle's wife
선비	classical scholar

닫히다	to be closed, to shut

패션	fashion, style

보육원	orphanage
실물	real [life] (as opposed to a picture or a model)
보고서	report, paper
몽고	Mongolia
작은아버지	father's younger brother

작은어머니	the wife of father's younger brother

바이올린	violin

미술관	art museum
올려놓다	to put a thing on a place

여유	marginsomething that exists (time, money, composure...)
준비물	preparation material, stuff
소년원	youth detention center
베이징	Beijing

액세서리	accessories

탤런트	TV actor, TV star

발라드	ballad

연봉	annual salary
조조	early morning
호의	goodwill, kindness
무관심하다	to be indifferent, unconcerned
출소하다	to be released from prison
듯하다	to look like, seem, look as if

괴짜	odd (eccentric) person
지성	brain power, intelligencesincerity, devotion
비축하다	to reserve, stock up (on)
왜곡하다	to distort, twist
새침하다	to be coy, prim

얄밉다	to be mean, nasty, provoking

무기	arms, weapon
방대하다	to be huge, vast, massive
우유부단하다	to be indecisive
준수하다	to abide by, comply with, obey [rules, law]
배반	betrayal
사직하다	to resign, step down
필독	required reading
비결	secret, key (of how to do something)
눈보라	snowstorm

자음	consonant
선적	shipment, shippingthe nationality of a ship
강요	enforcement, coercion
감미롭다	to be sweet, mellow
농장	farm, ranch
방귀	fart

충동	impulse, urge
민주주의	democracy
사또	district magistrate
이내	within, less thansoon, at once
세끼	three meals (a day)

삐치다	to sulk

독자	reader, subscriber
변경	change, alteration
동그랗다	to be round

정체	identity, true character
드러나다	to be exposed, emerge, come out

섬세하다	to be delicate, fine
막걸리	raw rice wine

경쟁자	rival, competitor
걷히다	to clear up, lift

용모	appearance, look, face
사이좋게	on good terms, friendly, in harmony

난민	refugee
식량	food, provision
금붕어	goldfish
새장	bird cage
인증	certification, confirmation
간직하다	to cherish, treasure, keep

면	side, facecotton
심지어	even, what is more<br />
유령	ghost
긍정적	positive, affirmative
반나절	six hours, half the day
악취	bad smell, stink
죄짓다	to commit a sin, do sinful things
소망	wish, hope, desire
망원경	telescope
게시판	bulletin board, notice board
민생	public welfare, people's livelihood
친부모	one's birth parents
연설	speech, address
선입견	prejudice, preconcieved notion
주먹밥	rice balls

수사	investigationnumeral
열애	passionate love
소속사	agency, management company
교제	association, acquaintance, society
시점	point in timepoint of view
차원	level, dimension
떠가다	to float, drift

측	side
게재하다	to print, publish
목격자	eyewitness
게시물	post (on the internet etc.)
동행하다	to accompany
목청껏	at the top of one's voice

전날	the day before, previously
서리	frost

유부녀	married woman
묘	grave, tomb
아래쪽	down, lower part

상반기	the first half of the year
제왕	king, emperor
사슴	deer

미신	superstition
결석하다	to be absent (from school)
괴담	ghost story
사치스럽다	to be luxurious, extravagant
총동원하다	to mobilize all the resources
멍청하다	to be stupid, dumb

패배하다	to be defeated
총점	total score
왕자	prince
상인	merchant, dealer
애정	love, affection
과시하다	to show off, parade
배신자	betrayer, traitor
까먹다	to forgetto peel and eatto use up

야식	late-night snack
홍수	flood
따로따로	separately, individually

사돈	relatives by marriage, in-laws
창가	area near window
보안	security
직진하다	to go straight
치수	size, measurement
완결	completion, conclusion
사냥하다	to hunt

야외	outside, open air
질병	disease, illness
접하다	to learn, hear
띄우다	to make something fly or floatto send

속담	saying, proverb
하마	hippo
호두	walnut

좋아지다	to become betterto become fond of
닷새	five days

하여튼	anyway, anyhow, in any case
뇌	brain
벼	rice

웨이터	waiter

성실하다	to be sincere, faithful
애독자	(devoted) reader
햄	ham

베이지색	beige

접촉	contact, touch
수화기	telephone receiver
액운	bad luck, misfortune
명단	list of names
어학연수	language study abroad
책자	booklet, brochure
입장권	admission ticket
과수원	orchard, fruit garden
동구	entrance to a village
거르다	to skip, missto filter (out)

끼니	meal

검사관	inspector, examiner
당첨되다	to win the prize
선곡	selection of music
마무리하다	to finish, finalize, complete

욕설	insult, abusive language
입장	position, situationadmission
학제	school system
이력서	resume, CV
연차	annual
월차	every month, monthly
거래	deal, dealings, trade
매출	sales
협상	negotiation, talks
접대	entertainment, reception, hospitality
선박	big ship
정감	feeling, emotion, sentiment
개학하다	for school to start (after vacations)
어설프다	to be imperfect, not adequate, sloppy

익명	anonymity
돌아서다	to turn (around)

아득하다	to be far away, in the distance

문맹	illiteracy
손발	hands and feet

예민하다	to be sharp, keen, acute, sensitive
상무	director
긴장감	tension, suspense
무난하다	to be easy, safe, acceptable
오그라들다	to shrink, shrivel

어미	ending(animal) mother
일꾼	worker

다소	more or less, to some degree
산뜻하다	to be fresh, refreshing

차분하다	to be calm, cool

기일	anniversary of one's deathfixed date, appointed day
소송	lawsuit
변태	pervert
출세하다	to have great success in life
음모	conspiracy, scheme
계략	scheme, trick, plot
문득	suddenly

내쉬다	to exhale, breathe out

의욕	will, drive
봉변	humiliation, mishap
헐다	to tear down, demolish

정수기	water purifier
쓰러지다	to fall down, drop down, collapse

생방송	live broadcast
묘미	charm, beauty
공손하다	to be polite, courteous
명찰	name tag
자취	trace, trail

무의식적	unconscious, involuntary
상큼하다	to be fresh, refreshing

멍들다	to get a bruise

명곡	classic, musical masterpiece
대결	contest, confrontation, fight
중독성	addictivenesstoxicity
마귀할멈	witch
또박또박	clearly, neatly

식상하다	to be fed up, sick and tired
시범	setting an example, demonstration
하나씩	one by one

하락	drop, fall, decrease
물어내다	to pay for, compensate

눈길	snowy roadeyes, line of vision

회의실	conference room
계산대	counter, checkout
국회	national assembly
동아줄	rope

깃털	feather

독서실	reading room
상금	prize money, award (cash)
사극	historical drama
여사	Mrs., madame
주거	residence, dwelling
범위	scope, range, extent, limits
별명	nickname
유출되다	to be spilled, leaked
중복	overlap, duplication
수락	acceptance, consent
등급	class, grade, ranking
뒤져보다	to look for, hunt after, rummage

수정	modificationcorrectionfertilization
분주하다	to be busy
꽃잎	petal

흩날리다	to scatter, flutter, blow

비틀다	to twist

넘치다	to overflow, run over

반기다	to greet, welcome

미남	good-looking man
학문	learning, study
청와대	the Blue House, Korean presidential mansion
강제	coercion, by force
황색	yellow
노년기	old age
잔인하다	to be cruel, brutal
분장하다	to put on make up, dress as
벌리다	to open, widen, stretch out

충치	cavity, decayed tooth
꾸준히	steadily, consistently

흔들리다	to shake, sway, quake

미녀	beautiful woman
왕비	queen, empress
귀국하다	to return to one's home country
중순	the middle ten days of a month
발휘하다	to demonstrate, show
지장	hindrance, obstacle, harmthumbprint
시댁	one's husband's home (family)
곧잘	quite well, frequently

어구	phrasefishing gear
재작년	two years ago
비자	visa

기러기	wild goose

바구니	wicker basket

소나무	pine tree

저고리	Korean traditional jacket

투수	pitcher
도토리	acorn

까치	magpie

폐	lungstrouble
외래어	loan words
궤도	track, orbit
외가	one's mother's parents' home
신작	new (piece of) work
늪	swamp, marsh, bog

분식	flour-based food
장님	blind person

펄럭펄럭	with a flutter, flapping

기이하다	to be strange, odd
내려앉다	to collapse, fall down

허용되다	to be permitted, be approved
쪽지	note, message
실명	one's real nameblindness
바늘	needle

앞줄	front row

생강	ginger
헛소문	groundless rumor
물비누	liquid soap

통합	combination, integration, unity
입장료	admission fee
일시	date and timefor a time
저자	author
강사	speaker, lecturer, instructor
수다쟁이	talkative person

기차역	train station
안내원	guide
나열하다	to list
햇빛	sunlight, sunshine

사진관	photo studio
주중	weekdays
원룸	studio (apartment)

새다	to leak, escapeto dawn

보증금	(security) deposit
타자	typingbatter, hitter
상대편	the other party
개시하다	to begin, start, open
중개인	broker, agent, middleman
쇼핑센터	shopping center

전세	lease of a house on a deposit basischarterwar situation
집주인	landlord, house owner
놀이기구	amusement park rides
전달하다	to deliver, convey
베란다	porch

별나다	to be peculiar, strange
칼날	blade of a knife
권력	power
굳이	firmly, positively
국화	chrysanthemum
좁히다	to narrow, restrict
장가가다	to get married (for a man)

감시하다	to watch, observe, do surveillance
운영하다	to manage, run, operate
설치	installation
폭로하다	to disclose, expose
상	award, prizetable
할부	monthly installment plan
초보자	beginner, novice
조정	adjustment, modificationmediationrowing
무디다	to be blunt, dull

눈빛	eyes, look

우수하다	to be superior, excellent
고무신	rubber shoes

해롭다	to be harmful, bad
축소하다	to reduce, cut down
물집	blister

절레절레	shaking one's head

거두다	to harvest, reap, gain

곡식	grain, cereals
오락	entertainment, pastime, recreation
하이웨이	highway

산꼭대기	top of a mountain
전환	change, switch
코스	course, route

전문적	specialized, professional
옷차림	dress, attire, getup

지팡이	walking stick, cane, wand

계곡	valley
유리창	glass window
보호자	guardian, protector
보건소	health center
기혼	married
일상생활	everyday life
만담	gag, comic talk
밥맛	appetite

친근하다	to be familiar, informal, friendly
개방하다	to open, unbar
잠옷	pajamas, nightclothes

놀이동산	amusement park

송별회	farewell party
공공기관	public institution
처방전	prescription
시행	enforcement, implementation
구청	district office
수년	a number of years
불법	illegality, unlawfulness
강당	lecture hall
핫도그	hotdog

학생회관	student center
찬밥	cold boiled rice

물리학	physics
변소	bathroom, toilet
조교	teaching assistant
룸메이트	roommate

외아들	only son

가렵다	to be itchy, feel itchy

물리다	to be bittento be fed up

재생하다	to remake, regenerate, recycle, play [a video]
공학	engineering
당초에	initially, originally
쾌적하다	to be pleasant, nice, comfortable
칼국수	chopped noodles

쌈밥	rice wrapped in greens

바퀴	wheel roundcockroach

썰매	sled, sleigh

망가지다	to break down, be damaged

인출하다	to withdraw
적히다	to be written down

전봇대	telephone pole
새기다	to engrave, carve

길가	roadside

석유	oil, petroleum
머리핀	hairpin

정찰제	fixed-price system
측면	side, flank
도구	tool, instrument
수단	means, way
주어	subject
친목	friendship
행인	passerby, pedestrian
전골	beef with vegetables cooked in a casserole

무역항	trade port
대도시	big city
수족관	aquarium
물속	inside water

식물원	botanical garden
새끼손가락	little finger

사당	shrine
휴양지	rest area, resort, vacation spot
여행지	destination
복종하다	to obey
기껏	to the best of one's ability

대리	deputy, proxy
김장	kimchi prepared for the winter

한옥	Korean-style house
열매	fruit, nut, berry

진행자	presenter, host, MC
지폐	paper money
대청소	general cleaning
국자	ladle

앞뒤	front and back, before and behind

대조하다	to contrast, compare
체력	physical strength
의무	obligation, duty
기획	planning
부서	department, division
의뢰인	client
짠돌이	cheap (stingy, frugal) person

튀김	fried food

메모지	memo pad, notepad
비기다	to end in a tie

환갑	sixtieth birthday
적응하다	to adapt, adjust
고사	examination
골	goalvalleybrain

하키	hockey

법학	law
인용	quotation, citation
판사	judge
긋다	to draw a line

기본형	basic form
기다	to crawl

어지르다	to make a mess

초청하다	to invite
확장하다	to expand, extend
오류	error, mistake
문의	inquiry
관리자	manager, administrator
체계	system
만족도	level of satisfaction
개편	reorganization, reform
제시간	scheduled time, appropriate time
여부	or not
이용자	user
단독	single, solo, independent
상승하다	to rise, climb, increase
입양하다	to adopt a child
이빨	tooth

손주	grandchildren
무능력하다	to be incompetent, incapable
비닐	plastic, vinyl

분리하다	to separate
원상복구	restoration to the original state
은퇴하다	to retire
새어머니	stepmother

가면	mask
채권자	creditor
채무	debt
불륜	affair, adultery
초점	focus
정면	front, facade
악마	devil
분리수거하다	to separate (trash)
탈진하다	to be exhausted, drained
액체	liquid
우두머리	leader, chief, boss

앞일	future
조직	group, organization
구성원	member
상업	commerce, business
금하다	to prohibit, forbid, ban
고유하다	to be unique, distinct, innate
밤낮	day and night

동의어	synonym
학점	credit, grade
대출	loan, lending
출력하다	to print out
경비	expensesguard, security
철학	philosophy
유형	type, category
단서	clue, leadcondition
올케	the wife of a girl's brother

전망	view, prospect
장단점	pros and cons, strengths and weaknesses
관리비	management expenses, maintenance cost
결제	payment
금액	amount of money
추첨하다	to draw lots
농가	farmhouse, farming family
벨트	belt

한도	limit (regarding money)
계좌	bank account
합리적	rational, reasonable
망상	delusion
수직	vertical
매형	one's elder sister's husband
낭독하다	to read aloud, recite
맛보다	to taste, try

윗사람	one's senior, one's superior

눈부처	one's image reflected in a person's eye

처남	brother of one's wife
청혼하다	to propose marriage
창	windowspear
표적	target
혼란	confusion, turmoil, chaos
덫	trap, snare

청첩장	wedding invitation
태우다	to burnto give a ride, take aboard

차편	transportation
마땅하다	to be suitable, appropriate, to deserve

시체	corpse
탄생하다	to be born
일정	schedule
당구	billiards
가뭄	drought

자수하다	to turn oneself in
대가족	large family, extended family
떠올리다	to recall, recollect

줄어들다	to grow smaller, decrease

설문지	questionnaire
콤플렉스	complex

광화문	Gwang Hwa Gate
광장	plaza, square
둘러싸다	to surround, enclose

당기다	to pull, draw, yank

감각	sense, feeling
샅샅이	everywhere, all over

꽃바구니	flower basket

찻집	teahouse
묶다	to tie, bind

목수	carpenter
미지근하다	to be lukewarm, tepid

앵무새	parrot
요술	magic, sorcery
가라앉다	to sink, settle

촛불	candlelight

서예	calligraphy
탈춤	masked dance

에펠탑	Eiffel Tower
체류하다	to stay
면회	visit
신세	debt
며느리	daughter-in-law

승리	victory
좌측	one's left
노선도	route map
따위	etc., and the like

날로	day by dayraw, uncooked

알아차리다	to realize, notice

운수	fortune, lucktransportation
유래	origin
이를테면	for instance, so to speak

계기	opportunity, motiveinstrument
청명하다	to be fine, clear
재능	talent, gift
정책	policy
논란	controversy, dispute
취지	purpose, object
오염되다	to be contaminated, polluted
능히	easily
전보	telegram
등기우편	registered mail
우체통	mailbox
집어넣다	to put into, bring in

창구	window, counter
성능	efficiency, performance
환율	exchange rate
원작	original (work)
받아쓰다	to take dictation, write down

도우미	helper, assistant

큰아들	one's eldest son

짭짤하다	to be a little salty

열연	enthusiastic performance
덮이다	to be covered

앓다	to be ill, suffer, be troubled

본래	originally, primarily, by nature
펼쳐지다	to spread, stretch out, unfold
